HDHHHHHHHHHHHHHHHHHHHHHHHHHHHHHHHHHHHHHHHHHHHHHHHHHHHHHHHHHHHHHH
H.H.....H......H.H.............................................H
D.......H......D.D.............................................H
H.H.....H......H.H.............................................H
H.HHHHHHH......H.H.............................................H
D.D............D.D.............................................H
H.H............H.H.............................................H
H.H............H.H.............................................H
D.D............D.D.............................................H
P.H............H.HHHHHH........................................H
H.H............H.H....H........................................H
D.D............D.D....H........................................H
H.H............H.H.HHHH........................................H
H.H............H.H....H........................................H
D.D............D......H........................................H
P.H............H.H....H........................................H
H.H............H.HHHHHH........................................H
D.D............D.D.............................................H
H.H............H.H.............................................H
H.H............H.H.............................................H
D.D............D.H.............................................H
H.H............H.H.............................................H
H.HHHHHH.......H.H.............................................H
D......H.......D.H.............................................H
P.H....H.......H.H.............................................H
H.HHHHHH.......H.H.............................................H
H.D............D.H.............................................H
H.H............H.H.............................................H
H.HHEHEHPHHEHEHH.HHDHHDHHDHHDHHDHHDHHDHHDHHDHH.HHDHHDHHDHHDHHDHH
H..............................................................H
@..............................................................H
@..............................................................H
@..............................................................H
H..............................................................H
H..............................................................H
H..............................................................H
H..............................................................H
H..............................................................H
H..............................................................H
H..............................................................H
H..............................................................H
H..............................................................H
H..............................................................H
H..............................................................H
H..............................................................H
H..............................................................H
H..............................................................H
H..............................................................H
H..............................................................H
H..............................................................H
H..............................................................H
H..............................................................H
H..............................................................H
H..............................................................H
H..............................................................H
H..............................................................H
H..............................................................H
H..............................................................H
H..............................................................H
H..............................................................H
H..............................................................H
H..............................................................H
H..............................................................H
HHHHHHHHHHHHHHHHHHHHHHHHHHHHHHHHHHHHHHHHHHHHHHHHHHHHHHHHHHHHHHHH