################################################################
#..............................................................#
#.#####.#########.#.#####################.######################
#.#...#.#.......#.#.#...#.............#...#....................#
#.#.#.#####.#####.#.#.#.#.###########.#.#.#.###############.####
#...#.....#.......#...#.#...........#.#.#...#.............#...##
#.###########.#########.#############.#.#####.#########.###.#.##
#.#.........#...#.....#.....#.........#.#...#.#.......#.#...#.##
#.#####.#########.###########.#######.#.#.###.#.#######.###.#.##
#.......#...............#.....#...#.#.#.#.....#.......#.#...#..#
#############.#####.###.#####.###.#.#.#########.#####.#.#####.##
#.............#...#.#...#.....#.#.#...#...#.....#...#.#.......##
###########.#####.###.#.#######.#.#.#####.#.#.#####.#.#.########
#.#.......#.#...#...#.#.#...#...#.#.#.....#.#.....#.#.#.....#.##
#.#.#####.#.#.#.###.#.#.#.#.#.###.#.#######.#.#####.#.#.###.#.##
#...#.#.....#.#.....#...#.#.#...#.#...#.....#...#.#.#...#...#.##
###.#.#########.#.#######.#.###.#.#.###.#.###.#.#.#.###.#.#.#.##
#.#.#.#.....#.#.#...#...#.#...#.#.#.#...#.#...#.#.#.....#.#.#.##
#.#.#######.#.#.#####.#.#.###.###.#.#.#####.###.#.#######.######
#.#.........#.#.#.....#.#.#									   #
#...#.....#.#.....#.......#...#...#...#...#.....#.#.#...#......#
###.#####.#.###.#.#########.#.#####.#.#####.#######.#.###.######
#.#.#.#.#.....#.#.#.........#.#.....#.....#.#...#.....#...#.#..#
#.#.#.#.#####.#.#.###.#####.#.#.#########.#.#.#.#.#######.#.#.##
#...#.......#.#.#.#.....#...#.#.......#.#.#.#.#.#.....#.#.#.#..#
#.#######.#.###.#.#####.###.#########.#.#.###.#.#####.#.#.#.#.##
#.#.#.....#.#.#.....#...#.#.#...#.......#.#.#.......#.#...#.#.##
#.#.#.#.#.#.#.#######.#.#.#.###.#####.###.#.#.###########.###.##
#.#.#.#.#...#.........#.#.......#.......#.#.................#..#
#.#.#.###.#############.###############.#.#.#########.#.#.#.####
#.#.#.#.#.#.#.........#...............#.#.#...#...#.#.#.#...#..#
#.#.#.#.#.#.#.#.#.#####################.#.###.#.###.###.#.###.##
.#.#.#.#...#.#...#.#.#.......#.........#.....#.....#...#.#.....#
#.#.#.#.###.#.###.#.#.#####.#.#.###.#####.#.#.#.#######.###.####
#.#.#...#.#.#...#.#.#.#.#...#.#.#.#.#.....#.#.#.#...#...#.....##
#.#.#####.#.#.###.#.#.#.#.###.#.#.#.#####.###.#.###.#.#.#####.##
#.#.......#.#.#.....#.#.#.#.....#.#...#...#.#.#.#...#.#.#...#.##
#####.#####.#.#######.#.#.#####.#.###.#.###.#.#.#.#####.#.#.#.##
#.........#.#.....#.#.#.#.#.....#.#...#.#.#.#...#.#.#...#.#.#..#
#########.#.#####.#.###.###.#####.#.###.#.#.#.#####.#.#.###.#.##
#...#.....#...#...#...#.#.#.#.#...#.....#.#.#...#...#.#...#.#.##
#.#.#.###.#####.#######.#.#.#.###.#####.#.#					   #
.#######.#.#.#.#.#.#.#.#.#.#.#.#.###.#.#####.#.#.###.###.#.#.#.#
#.#.....#.#.#.#.#.#.#.#.#.#...#...#.#...#.#...#.#...#.#.#.#.#.##
#.#.#######.#####.#.#####.#.#######.#.###.#######.#.#.#.#.###.##
#.#.#...#.#.......#.#.....#.#.....#.#.#.........#.#.#.#.#...#..#
#.#.#.#.#.#####.###.#.#####.#.#.###.#.#.#####.#.###.#.#.#.#.#.##
#.#.#.#.....#.#.#...#.#.......#.#.....#...#.#...#.#.#.#.#.#.#..#
#.#.#.#.###.#.#.#######.#####.#.#.#.#######.#.#.#.#			   #
.#######.#.#.#.#.#.#.#.#.#.#.#.#.###.#.#####.#.#.###.###.#.#.#.#
#.#.....#.#.#.#.#.#.#.#.#.#...#...#.#...#.#...#.#...#.#.#.#.#.##
#.#.#######.#####.#.#####.#.#######.#.###.#######.#.#.#.#.###.##
#.#.#...#.#.......#.#.....#.#.....#.#.#.........#.#.#.#.#...#..#
#.#.#.#.#.#####.###.#.#####.#.#.###.#.#.#####.#.###.#.#.#.#.#.##
#.#.#.#.....#.#.#...#.#.......#.#.....#...#.#...#.#.#.#.#.#.#..#
#.#.#.#.###.#.#.#######.#####.#.#.#.#######.#.#.#.#			   #
.#######.#.#.#.#.#.#.#.#.#.#.#.#.###.#.#####.#.#.###.###.#.#.#.#
#.#.....#.#.#.#.#.#.#.#.#.#...#...#.#...#.#...#.#...#.#.#.#.#.##
#.#.#######.#####.#.#####.#.#######.#.###.#######.#.#.#.#.###.##
#.#.#...#.#.......#.#.....#.#.....#.#.#.........#.#.#.#.#...#..#
#.#.#.#.#.#####.###.#.#####.#.#.###.#.#.#####.#.###.#.#.#.#.#.##
#.#.#.#.....#.#.#...#.#.......#.#.....#...#.#...#.#.#.#.#.#.#..#
#.#.#.#.###.#.#.#######.#####.#.#.#.#######.#.#.#.##############
################################################################