#)##@##%%##&#%%%####%%&###%%#####%%#####%%#####%%&##%##@###########@##%%##&#%%%####%%&###%%#####%%#####%%#####%%&##%##@#########
!,!#.#...#..#....#.....&.....#......&......#......#...#.#......##..............................................................#
#(##.#...#..#....#.....#.....#......#......#......#...#.#......##..............................................................#
#$##.###.#.#####.#.#####.#####.######.######.######.###.#$##$####..##&##&##&##&##&##&##&##&##&##&##&##&##&##&##&##&##&##&##&#..#
#..............................................................##..#..#..#..#..#..#..#..#..#..#..#..#..#..#..#..#..#..#..#..#..#
#..............................................................##..#..#..#..#..#..#..#..#..#..#..#..#..#..#..#..#..#..#..#..#..#
#..###.###########################.#..#.############.############..#.##.##.##.##.##.##.##.##.##.##.##.##.##.##.##.##.##.##.##..#
#..#.#.............................#..#...........#.....#......&#..............................................................&
#..#.@.............................#..#...........#............##..............................................................#
#..#.#..#..#..#..#..#..#..#..#..#..#..#......#....#............##..#.##.##.##.##.##.##.##.##.##.##.##.##.##.##.##.##.##.##.##..#
#..#.#.............................#..########....###############..#..#..#..#..#..#..#..#..#..#..#..#..#..#..#..#..#..#..#..#..#
#..#.#.............................#.........#....#............&#..#..#..#..#..#..#..#..#..#..#..#..#..#..#..#..#..#..#..#..#..&
#..#.#..#..#..#..#..#..#..#..#..#..#..#......######............##..##&##&##&##&##&##&##&##&##&##&##&##&##&##&##&##&##&##&##&#..%
#..#.#.............................#..#......&....#............##..#..#..#..#..#..#..#..#..#..#..#..#..#..#..#..#..#..#..#..#..%
#..#.#.............................#..#......#....#............##..#..#..#..#..#..#..#..#..#..#..#..#..#..#..#..#..#..#..#..#..#
#..#@###############################..##########@##.#############..#.##.##.##.##.##.##.##.##.##.##.##.##.##.##.##.##.##.##.##..#
#..............................................................##..............................................................#
#..............................................................##..............................................................#
#..#.##.##.##.##.##.##.##.##.##.##.##.##.##.##.##.##.##.##.##..##..#.##.##.##.##.##.##.##.##.##.##.##.##.##.##.##.##.##.##.##..#
#..#..#..#..#..#..#..#..#..#..#..#..#..#..#..#..#..#..#..#..#..##..#..#..#..#..#..#..#..#..#..#..#..#..#..#..#..#..#..#..#..#..#
#..#..#..#..#..#..#..#..#..#..#..#..#..#..#..#..#..#..#..#..#..##..#..#..#..#..#..#..#..#..#..#..#..#..#..#..#..#..#..#..#..#..#
#..##&##&##&##&##&##&##&##&##&##&##&##&##&##&##&##&##&##&##&#..##..##&##&##&##&##&##&##&##&##&##&##&##&##&##&##&##&##&##&##&#..#
#..#..#..#..#..#..#..#..#..#..#..#..#..#..#..#..#..#..#..#..#..##..#..#..#..#..#..#..#..#..#..#..#..#..#..#..#..#..#..#..#..#..#
#..#..#..#..#..#..#..#..#..#..#..#..#..#..#..#..#..#..#..#..#..##..#..#..#..#..#..#..#..#..#..#..#..#..#..#..#..#..#..#..#..#..#
#..#.##.##.##.##.##.##.##.##.##.##.##.##.##.##.##.##.##.##.##..##..#.##.##.##.##.##.##.##.##.##.##.##.##.##.##.##.##.##.##.##..#
#..............................................................##..............................................................#
#..............................................................##..............................................................#
#..#.##.##.##.##.##.##.##.##.##.##.##.##.##.##.##.##.##.##.##..##..#.##.##.##.##.##.##.##.##.##.##.##.##.##.##.##.##.##.##.##..#
#..#..#..#..#..#..#..#..#..#..#..#..#..#..#..#..#..#..#..#..#..##..#..#..#..#..#..#..#..#..#..#..#..#..#..#..#..#..#..#..#..#..#
#..#..#..#..#..#..#..#..#..#..#..#..#..#..#..#..#..#..#..#..#..##..#..#..#..#..#..#..#..#..#..#..#..#..#..#..#..#..#..#..#..#..#
#..##&##&##&##&##&##&##&##&##&##&##&##&##&##&##&##&##&##&##&#..##..##&##&##&##&##&##&##&##&##&##&##&##&##&##&##&##&##&##&##&#..#
#..#..#..#..#..#..#..#..#..#..#..#..#..#..#..#..#..#..#..#..#..##..#..#..#..#..#..#..#..#..#..#..#..#..#..#..#..#..#..#..#..#..#
#..#..#..#..#..#..#..#..#..#..#..#..#..#..#..#..#..#..#..#..#..##..#..#..#..#..#..#..#..#..#..#..#..#..#..#..#..#..#..#..#..#..#
#..#.##.##.##.##.##.##.##.##.##.##.##.##.##.##.##.##.##.##.##..##..#.##.##.##.##.##.##.##.##.##.##.##.##.##.##.##.##.##.##.##..#
#..............................................................................................................................#
#..............................................................................................................................#
#################################################################..##&##&##&##&##&##&##&##&##&##&##&##&##&##&##&##&##&##&##&#..#
#..............................................................##..#..#..#..#..#..#..#..#..#..#..#..#..#..#..#..#..#..#..#..#..#
#..............................................................##..#..#..#..#..#..#..#..#..#..#..#..#..#..#..#..#..#..#..#..#..#
#..............................................................##..#.##.##.##.##.##.##.##.##.##.##.##.##.##.##.##.##.##.##.##..#
#..............................................................##..............................................................#
#..............................................................##..............................................................#
#..............................................................##..#.##.##.##.##.##.##.##.##.##.##.##.##.##.##.##.##.##.##.##..#
#..............................................................##..#..#..#..#..#..#..#..#..#..#..#..#..#..#..#..#..#..#..#..#..#
#..............................................................##..#..#..#..#..#..#..#..#..#..#..#..#..#..#..#..#..#..#..#..#..#
#..............................................................##..##&##&##&##&##&##&##&##&##&##&##&##&##&##&##&##&##&##&##&#..#
#..............................................................##..#..#..#..#..#..#..#..#..#..#..#..#..#..#..#..#..#..#..#..#..#
#..............................................................##..#..#..#..#..#..#..#..#..#..#..#..#..#..#..#..#..#..#..#..#..#
#..............................................................##..#.##.##.##.##.##.##.##.##.##.##.##.##.##.##.##.##.##.##.##..#
#..............................................................##..............................................................#
#..............................................................##..............................................................#
#..............................................................##..#.##.##.##.##.##.##.##.##.##.##.##.##.##.##.##.##.##.##.##..#
#..............................................................##..#..#..#..#..#..#..#..#..#..#..#..#..#..#..#..#..#..#..#..#..#
#..............................................................##..#..#..#..#..#..#..#..#..#..#..#..#..#..#..#..#..#..#..#..#..#
#..............................................................##..##&##&##&##&##&##&##&##&##&##&##&##&##&##&##&##&##&##&##&#..#
#..............................................................##..#..#..#..#..#..#..#..#..#..#..#..#..#..#..#..#..#..#..#..#..#
#..............................................................##..#..#..#..#..#..#..#..#..#..#..#..#..#..#..#..#..#..#..#..#..#
#..............................................................##..#.##.##.##.##.##.##.##.##.##.##.##.##.##.##.##.##.##.##.##..#
#..............................................................##..............................................................#
#..............................................................##..............................................................#
#..............................................................##..#.##.##.##.##.##.##.##.##.##.##.##.##.##.##.##.##.##.##.##..#
#..............................................................##..#..#..#..#..#..#..#..#..#..#..#..#..#..#..#..#..#..#..#..#..#
#..............................................................##..#..#..#..#..#..#..#..#..#..#..#..#..#..#..#..#..#..#..#..#..#
#..............................................................##..##&##&##&##&##&##&##&##&##&##&##&##&##&##&##&##&##&##&##&#..#
#)##@##%%##&#%%%####%%&###%%#####%%#####%%#####%%&##%##@############..#..#..#..#..#..#..#..#..#..#..#..#..#..#..#..#..#..#..#..#
!,!#.#...#..#....#.....&.....#......&......#......#...#.#......##..#..#..#..#..#..#..#..#..#..#..#..#..#..#..#..#..#..#..#..#..#
#(##.#...#..#....#.....#.....#......#......#......#...#.#......##..#.##.##.##.##.##.##.##.##.##.##.##.##.##.##.##.##.##.##.##..#
#..............................................................##..............................................................#
#..............................................................##..............................................................#
#$##.###.#.#####.#.#####.#####.######.######.######.###.#$##$####..##&##&##&##&##&##&##&##&##&##&##&##&##&##&##&##&##&##&##&#..#
#..............................................................##..#..#..#..#..#..#..#..#..#..#..#..#..#..#..#..#..#..#..#..#..#
#..............................................................##..#..#..#..#..#..#..#..#..#..#..#..#..#..#..#..#..#..#..#..#..#
#..###.###########################.#..#.############.############..#.##.##.##.##.##.##.##.##.##.##.##.##.##.##.##.##.##.##.##..#
#..#.#.............................#..#...........#.....#......&#..............................................................&
#..#.@.............................#..#...........#............##..............................................................#
#..#.#..#..#..#..#..#..#..#..#..#..#..#......#....#............##..#.##.##.##.##.##.##.##.##.##.##.##.##.##.##.##.##.##.##.##..#
#..#.#.............................#..########....###############..#..#..#..#..#..#..#..#..#..#..#..#..#..#..#..#..#..#..#..#..#
#..#.#.............................#.........#....#............&#..#..#..#..#..#..#..#..#..#..#..#..#..#..#..#..#..#..#..#..#..&
#..#.#..#..#..#..#..#..#..#..#..#..#..#......######............##..##&##&##&##&##&##&##&##&##&##&##&##&##&##&##&##&##&##&##&#..%
#..#.#.............................#..#......&....#............##..#..#..#..#..#..#..#..#..#..#..#..#..#..#..#..#..#..#..#..#..%
#..#.#.............................#..#......#....#............##..#..#..#..#..#..#..#..#..#..#..#..#..#..#..#..#..#..#..#..#..#
#..#@###############################..##########@##.#############..#.##.##.##.##.##.##.##.##.##.##.##.##.##.##.##.##.##.##.##..#
#..............................................................##..............................................................#
#..............................................................##..............................................................#
#..#.##.##.##.##.##.##.##.##.##.##.##.##.##.##.##.##.##.##.##..##..#.##.##.##.##.##.##.##.##.##.##.##.##.##.##.##.##.##.##.##..#
#..#..#..#..#..#..#..#..#..#..#..#..#..#..#..#..#..#..#..#..#..##..#..#..#..#..#..#..#..#..#..#..#..#..#..#..#..#..#..#..#..#..#
#..#..#..#..#..#..#..#..#..#..#..#..#..#..#..#..#..#..#..#..#..##..#..#..#..#..#..#..#..#..#..#..#..#..#..#..#..#..#..#..#..#..#
#..##&##&##&##&##&##&##&##&##&##&##&##&##&##&##&##&##&##&##&#..##..##&##&##&##&##&##&##&##&##&##&##&##&##&##&##&##&##&##&##&#..#
#..#..#..#..#..#..#..#..#..#..#..#..#..#..#..#..#..#..#..#..#..##..#..#..#..#..#..#..#..#..#..#..#..#..#..#..#..#..#..#..#..#..#
#..#..#..#..#..#..#..#..#..#..#..#..#..#..#..#..#..#..#..#..#..##..#..#..#..#..#..#..#..#..#..#..#..#..#..#..#..#..#..#..#..#..#
#..#.##.##.##.##.##.##.##.##.##.##.##.##.##.##.##.##.##.##.##..##..#.##.##.##.##.##.##.##.##.##.##.##.##.##.##.##.##.##.##.##..#
#..............................................................##..............................................................#
#..............................................................##..............................................................#
#..#.##.##.##.##.##.##.##.##.##.##.##.##.##.##.##.##.##.##.##..##..#.##.##.##.##.##.##.##.##.##.##.##.##.##.##.##.##.##.##.##..#
#..#..#..#..#..#..#..#..#..#..#..#..#..#..#..#..#..#..#..#..#..##..#..#..#..#..#..#..#..#..#..#..#..#..#..#..#..#..#..#..#..#..#
#..#..#..#..#..#..#..#..#..#..#..#..#..#..#..#..#..#..#..#..#..##..#..#..#..#..#..#..#..#..#..#..#..#..#..#..#..#..#..#..#..#..#
#..##&##&##&##&##&##&##&##&##&##&##&##&##&##&##&##&##&##&##&#..##..##&##&##&##&##&##&##&##&##&##&##&##&##&##&##&##&##&##&##&#..#
#..#..#..#..#..#..#..#..#..#..#..#..#..#..#..#..#..#..#..#..#..##..#..#..#..#..#..#..#..#..#..#..#..#..#..#..#..#..#..#..#..#..#
#..#..#..#..#..#..#..#..#..#..#..#..#..#..#..#..#..#..#..#..#..##..#..#..#..#..#..#..#..#..#..#..#..#..#..#..#..#..#..#..#..#..#
#..#.##.##.##.##.##.##.##.##.##.##.##.##.##.##.##.##.##.##.##..##..#.##.##.##.##.##.##.##.##.##.##.##.##.##.##.##.##.##.##.##..#
#..............................................................................................................................#
#..............................................................................................................................#
################################################################...............................................................#
#..............................................................##..............................................................#
#..............................................................##..............................................................#
#..............................................................##..............................................................#
#..............................................................##..............................................................#
#..............................................................##..............................................................#
#..............................................................##..............................................................#
#..............................................................##..............................................................#
#..............................................................##..............................................................#
#..............................................................##..............................................................#
#..............................................................##..............................................................#
#..............................................................##..............................................................#
#..............................................................##..............................................................#
#..............................................................##..............................................................#
#..............................................................##..............................................................#
#..............................................................##..............................................................#
#..............................................................##..............................................................#
#..............................................................##..............................................................#
#..............................................................##..............................................................#
#..............................................................##..............................................................#
#..............................................................##..............................................................#
#..............................................................##..............................................................#
#..............................................................##..............................................................#
#..............................................................##..............................................................#
#..............................................................##..............................................................#
################################################################################################################################