################################################################
#.......#......................................................#
@.......#......................................................#
#.......#......................................................#
#####...#......................................................#
....#...#......................................................#
....#...#......................................................#
....#...#......................................................#
....#...#......................................................#
....#...#......................................................#
....#...#......................................................#
....#...#......................................................#
....#...#......................................................#
....#...#......................................................#
....#...#......................................................#
....#...#......................................................#
....#...#......................................................#
....#...#......................................................#
....#...#......................................................#
....#...#......................................................#
....#...#......................................................#
....#...#......................................................#
....#...#......................................................#
....#...#......................................................#
....#...#......................................................#
....#...#......................................................#
....#...#......................................................#
....#...#......................................................#
....#...#......................................................#
....#...#......................................................#
....#...#......................................................#
....#...#......................................................#
....#...#......................................................#
....#...#......................................................#
....#...#......................................................#
....#...#......................................................#
....#...#......................................................#
....#...#......................................................#
....#...#......................................................#
....#...#......................................................#
....#...#......................................................#
....#...#......................................................#
....#...#......................................................#
....#...#......................................................#
....#...#......................................................#
....#...#......................................................#
....#...#......................................................#
....#...#......................................................#
....#...#......................................................#
....#...#......................................................#
....#...#......................................................#
....#...#......................................................#
....#...#......................................................#
....#...#......................................................#
....#...#......................................................#
....#...#......................................................#
....#...#......................................................#
....#...#......................................................#
....#...#......................................................#
....#...#......................................................#
....#...#......................................................#
....#...#......................................................#
....#...#......................................................#
....#...#......................................................#
....#...#......................................................#
....#...#......................................................#
....#...#......................................................#
....#...#......................................................#
....#...#......................................................#
....#...#......................................................#
....#...#......................................................#
....#...#......................................................#
....#...#......................................................#
....#...#......................................................#
....#...#......................................................#
....#...#......................................................#
....#...#......................................................#
....#...#......................................................#
....#...#......................................................#
....#...#......................................................#
....#...#......................................................#
....#...#......................................................#
....#...#......................................................#
....#...#......................................................#
....#...#......................................................#
....#...#......................................................#
....#...#......................................................#
....#...#......................................................#
....#...#......................................................#
....#...#......................................................#
....#...#......................................................#
....#...#......................................................#
....#...#......................................................#
....#...#......................................................#
....#...#......................................................#
....#...#......................................................#
....#...#......................................................#
....#...#......................................................#
....#...#......................................................#
....#...#......................................................#
....#...#......................................................#
....#...#......................................................#
....#...#......................................................#
....#...#......................................................#
....#...#......................................................#
....#...#......................................................#
....#...#......................................................#
....#...#......................................................#
....#...#......................................................#
....#...#......................................................#
....#...#......................................................#
....#...#......................................................#
....#...#......................................................#
....#...#......................................................#
....#...#......................................................#
....#...#......................................................#
....#...#......................................................#
....#...#......................................................#
....#...#......................................................#
....#...#......................................................#
....#...#......................................................#
....#...#......................................................#
....#...#......................................................#
....#...#......................................................#
....#...#......................................................#
....#...#......................................................#
....#...#......................................................#
....#...#......................................................#
....#...#......................................................#
....#...#......................................................#
....#...#......................................................#
....#...#......................................................#
....#...#......................................................#
....#...#......................................................#
....#...#......................................................#
....#...#......................................................#
....#...#......................................................#
....#...#......................................................#
....#...#......................................................#
....#...#......................................................#
....#...#......................................................#
....#...#......................................................#
....#...#......................................................#
....#...#......................................................#
....#...#......................................................#
....#...#......................................................#
....#...#......................................................#
....#...#......................................................#
....#...#......................................................#
....#...#......................................................#
....#...#......................................................#
....#...#......................................................#
....#...#......................................................#
....#...#......................................................#
....#...#......................................................#
....#...#......................................................#
....#...#......................................................#
....#...#......................................................#
....#...#......................................................#
....#...#......................................................#
....#...#......................................................#
....#...#......................................................#
....#...#......................................................#
....#...#......................................................#
....#...#......................................................#
....#...#......................................................#
....#...#......................................................#
....#...#......................................................#
....#...#......................................................#
....#...#......................................................#
....#...#......................................................#
....#...#......................................................#
....#...#......................................................#
....#...#......................................................#
....#...#......................................................#
....#...#......................................................#
....#...#......................................................#
....#...#......................................................#
....#...#......................................................#
....#...#......................................................#
....#...#......................................................#
....#...#......................................................#
....#...#......................................................#
....#...#......................................................#
....#...#......................................................#
....#...#......................................................#
....#...#......................................................#
....#...#......................................................#
....#...#......................................................#
....#...#......................................................#
....#...#......................................................#
....#...#......................................................#
....#...#......................................................#
....#...#......................................................#
....#...#......................................................#
....#...#......................................................#
....#...#......................................................#
....#...#......................................................#
....#...#......................................................#
....#...#......................................................#
....#...#......................................................#
....#...#......................................................#
....#...#......................................................#
....#...#......................................................#
....#...#......................................................#
....#...#......................................................#
....#...#......................................................#
....#...#......................................................#
....#...#......................................................#
....#...#......................................................#
....#...#......................................................#
....#...#......................................................#
....#...#......................................................#
....#...#......................................................#
....#...#......................................................#
....#...#......................................................#
....#...#......................................................#
....#...#......................................................#
....#...#......................................................#
....#...#......................................................#
....#...#......................................................#
....#...#......................................................#
....#...#......................................................#
....#...#......................................................#
....#...#......................................................#
....#...#......................................................#
....#...#......................................................#
....#...#......................................................#
....#...#......................................................#
....#...#......................................................#
....#...#......................................................#
....#...#......................................................#
....#...#......................................................#
....#...#......................................................#
....#...#......................................................#
....#...#......................................................#
....#...#......................................................#
....#...#......................................................#
....#...#......................................................#
....#...#......................................................#
....#...#......................................................#
....#...#......................................................#
....#...#......................................................#
....#...#......................................................#
....#...#......................................................#
....#...#......................................................#
....#...#......................................................#
....#...#......................................................#
....#...#......................................................#
....#...#......................................................#
....#...#......................................................#
....#...#......................................................#
....#...#......................................................#
....#...#......................................................#
....#...#......................................................#
....#...#......................................................#
....#...#......................................................#
....#...#......................................................#
....#...#......................................................#
....#...#......................................................#
....#...#......................................................#
....#...#......................................................#
....#...#......................................................#
....#...#......................................................#
....#...#......................................................#
....#...#......................................................#
....#...#......................................................#
....#...#......................................................#
....#...#......................................................#
....#...#......................................................#
....#...#......................................................#
....#...#......................................................#
....#...#......................................................#
....#...#......................................................#
....#...#......................................................#
....#...#......................................................#
....#...#......................................................#
....#...#......................................................#
....#...#......................................................#
....#...#......................................................#
....#...#......................................................#
....#...#......................................................#
....#...#......................................................#
....#...#......................................................#
....#...#......................................................#
....#...#......................................................#
....#...#......................................................#
....#...#......................................................#
....#...#......................................................#
....#...#......................................................#
....#...#......................................................#
....#...#......................................................#
....#...#......................................................#
....#...#......................................................#
....#...#......................................................#
....#...#......................................................#
....#...#......................................................#
....#...#......................................................#
....#...#......................................................#
....#...#......................................................#
....#...#......................................................#
....#...#......................................................#
....#...#......................................................#
....#...#......................................................#
....#...#......................................................#
....#...#......................................................#
....#...#......................................................#
....#...#......................................................#
....#...#......................................................#
....#...#......................................................#
....#...#......................................................#
....#...#......................................................#
....#...#......................................................#
....#...#......................................................#
....#...#......................................................#
....#...#......................................................#
....#...#......................................................#
....#...#......................................................#
....#...#......................................................#
....#...#......................................................#
....#...#......................................................#
....#...#......................................................#
....#...#......................................................#
....#...#......................................................#
....#...#......................................................#
....#...#......................................................#
....#...#......................................................#
....#...#......................................................#
....#...#......................................................#
....#...#......................................................#
....#...#......................................................#
....#...#......................................................#
....#...#......................................................#
....#...#......................................................#
....#...#......................................................#
....#...#......................................................#
....#...#......................................................#
....#...#......................................................#
....#...#......................................................#
....#...#......................................................#
....#...#......................................................#
....#...#......................................................#
....#...#......................................................#
....#...#......................................................#
....#...#......................................................#
....#...#......................................................#
....#...#......................................................#
....#...#......................................................#
....#...#......................................................#
....#...#......................................................#
....#...#......................................................#
....#...#......................................................#
....#...#......................................................#
....#...#......................................................#
....#...#......................................................#
....#...#......................................................#
....#...#......................................................#
....#...#......................................................#
....#...#......................................................#
....#...#......................................................#
....#...#......................................................#
....#...#......................................................#
....#...#......................................................#
....#...#......................................................#
....#...#......................................................#
....#...#......................................................#
....#...#......................................................#
....#...#......................................................#
....#...#......................................................#
....#...#......................................................#
....#...#......................................................#
....#...#......................................................#
....#...#......................................................#
....#...#......................................................#
....#...#......................................................#
....#...#......................................................#
....#...#......................................................#
....#...#......................................................#
....#...#......................................................#
....#...#......................................................#
....#...#......................................................#
....#...#......................................................#
....#...#......................................................#
....#...#......................................................#
################################################################