#@#******#######################################################
#.#*,,,,*.....#.....#.....#.....#.....#.....#.....#.....#.....##
#.@],,,,*.....#.....#.....#.....#.....#.....#.....#.....#.....##
#.#*,,,,*.....#.....#.....#.....#.....#.....#.....#.....#.....##
#.#******.....#.....#.....#.....#.....#.....#.....#.....#.....##
@.########@#####@#####@#####@#####@#####@#####@#####@#####@#####
#..............................................................#
#.########@#####@#####@#####@#####@#####@#####@#####@#####@#####
#.#............................................................#
#.#............................................................#
#.#............................................................#
#.#............................................................#
#.#########@#####@#####@#####@#####@#####@#####@#####@#####@####
#..............................................................#
#.########@#####@#####@#####@#####@#####@#####@#####@#####@#####
#.#............................................................#
#.#............................................................#
#.#............................................................#
#.#............................................................#
#.#########@#####@#####@#####@#####@#####@#####@#####@#####@####
#..............................................................#
#.########@#####@#####@#####@#####@#####@#####@#####@#####@#####
#.#............................................................#
#.#............................................................#
#.#............................................................#
#.#............................................................#
#.#########@#####@#####@#####@#####@#####@#####@#####@#####@####
#.#.&........#............#WWWWPWWWWWWWWWWWPWWWWWWWWWWWWWWWWWWWW
#.#!_!.......#....................W............................W
#.#.^........#............#W......W............................W
#.##$##$##$###............#W..WWWWWWWWWWWWWWWWWWWWWWWWWWWWWWWWWW
#.........................#W...................................W
#.........................#W..WWWWWWWWWWWWWWWWWWWWWWWWWWWWWWWWWW
#.........................#W..W................................W
#.........................#W..P................................W
#.........................#W..W................................W
###########################W..WWWWWWWWWWWWWWWWWWWWWWWWWWWWWWWWWW
#..............................................................#
#..............................................................#
#..............................................................#
#..............................................................#
#..............................................................#
#..............................................................#
#..............................................................#
#..............................................................#
#..............................................................#
#..............................................................#
#..............................................................#
#..............................................................#
#..............................................................#
#..............................................................#
#..............................................................#
#..............................................................#
#..............................................................#
#..............................................................#
#..............................................................#
#..............................................................#
#..............................................................#
#..............................................................#
#..............................................................#
#..............................................................#
#..............................................................#
#..............................................................#
################################################################