@@@@@@@@@@@@@@@@@@@@@@@@@@@@@@@@@@@@@@@@@@@@@@@@@@@@@@@@@@@@@@@@@@@@@@@@@@@@@@@@@@@@@@@@@@@@@@@@@@@@@@@@@@@@@@@@@@@@@@@@@@@@@@@@
@;;;;;;;;;;;;;;;;;;;;;;;;;;;;;;@;;;;;;;;;;;;;;;;;;;;;;;;;;;;;;;;;;;;;;;;;;;;;;;;;;;;;;;;;;;;;;;@;;;;;;;;;;;;;;;;;;;;;;;;;;;;;;;@
@;;;;;;;;;;;;;;;;;;;;;;;;;;;;;;@;;;;;;;;;;;;;;;;;;;;;;;;;;;;;;;;;;;;;;;;;;;;;;;;;;;;;;;;;;;;;;;@;;;;;;;;;;;;;;;;;;;;;;;;;;;;;;;@
@;;;;@;;;@;;;;;;@;;;;@;;;;@;;;;@;;;;;@;;;;@;;;;;@;;;;@;;;;@;;;;@;;;;;@;;;@;;;;;;@;;;;@;;;;@;;;;@;;;;;@;;;;@;;;;;@;;;;@;;;;@;;;;@
@;;;;;;;;;;;;;;;@;;;;;;;;;;;;;;@;;;;;;;;;;;;;;;;@;;;;;;;;;;;;;;@;;;;;;;;;;;;;;;;@;;;;;;;;;;;;;;@;;;;;;;;;;;;;;;;@;;;;;;;;;;;;;;@
@;;;;;;;;;;;;;;;@;;;;;;;;;;;;;;@;;;;;;;;;;;;;;;;@;;;;;;;;;;;;;;@;;;;;;;;;;;;;;;;@;;;;;;;;;;;;;;@;;;;;;;;;;;;;;;;@;;;;;;;;;;;;;;@
@;;;;@;;;@;;;;;;@;;;;@;;;;@;;;;@;;;;;@;;;;@;;;;;@;;;;@;;;;@;;;;@;;;;;@;;;@;;;;;;@;;;;@;;;;@;;;;@;;;;;@;;;;@;;;;;@;;;;@;;;;@;;;;@
@;;;;;;;;;;;;;;;@;;;;;;;;;;;;;;@;;;;;;;;;;;;;;;;@;;;;;;;;;;;;;;@;;;;;;;;;;;;;;;;@;;;;;;;;;;;;;;@;;;;;;;;;;;;;;;;@;;;;;;;;;;;;;;@
@;;;;;;;;;;;;;;;@;;;;;;;;;;;;;;@;;;;;;;;;;;;;;;;@;;;;;;;;;;;;;;@;;;;;;;;;;;;;;;;@;;;;;;;;;;;;;;@;;;;;;;;;;;;;;;;@;;;;;;;;;;;;;;@
@;;;;$;;;$;;;;;;@;;;;$;;;;$;;;;@;;;;;$;;;;$;;;;;@;;;;$;;;;$;;;;@;;;;;$;;;$;;;;;;@;;;;$;;;;$;;;;@;;;;;$;;;;$;;;;;@;;;;$;;;;$;;;;@
@;;;;;;;;;;;;;;;@;;;;;;;;;;;;;;@;;;;;;;;;;;;;;;;@;;;;;;;;;;;;;;@;;;;;;;;;;;;;;;;@;;;;;;;;;;;;;;@;;;;;;;;;;;;;;;;@;;;;;;;;;;;;;;@
@;;;;;;;;;;;;;;;@;;;;;;;;;;;;;;@;;;;;;;;;;;;;;;;@;;;;;;;;;;;;;;@;;;;;;;;;;;;;;;;@;;;;;;;;;;;;;;@;;;;;;;;;;;;;;;;@;;;;;;;;;;;;;;@
@;;;;@;;;@;;;;;;@;;;;@;;;;@;;;;@;;;;;@;;;;@;;;;;@;;;;@;;;;@;;;;@;;;;;@;;;@;;;;;;@;;;;@;;;;@;;;;@;;;;;@;;;;@;;;;;@;;;;@;;;;@;;;;@
@;;;;;;;;;;;;;;;@;;;;;;;;;;;;;;@;;;;;;;;;;;;;;;;@;;;;;;;;;;;;;;@;;;;;;;;;;;;;;;;@;;;;;;;;;;;;;;@;;;;;;;;;;;;;;;;@;;;;;;;;;;;;;;@
@;;;;;;;;;;;;;;;@;;;;;;;;;;;;;;@;;;;;;;;;;;;;;;;@;;;;;;;;;;;;;;@;;;;;;;;;;;;;;;;@;;;;;;;;;;;;;;@;;;;;;;;;;;;;;;;@;;;;;;;;;;;;;;@
@;;;;@;;;@;;;;;;@;;;;@;;;;@;;;;;;;;;;@;;;;@;;;;;;;;;;@;;;;@;;;;@;;;;;@;;;@;;;;;;@;;;;@;;;;@;;;;;;;;;;@;;;;@;;;;;;;;;;@;;;;@;;;;@
@;;;;;;;;;;;;;;;@;;;;;;;;;;;;;;;;;;;;;;;;;;;;;;;;;;;;;;;;;;;;;;@;;;;;;;;;;;;;;;;@;;;;;;;;;;;;;;;;;;;;;;;;;;;;;;;;;;;;;;;;;;;;;;@
@;;;;;;;;;;;;;;;@;;;;;;;;;;;;;;;;;;;;;;;;;;;;;;;;;;;;;;;;;;;;;;@;;;;;;;;;;;;;;;;@;;;;;;;;;;;;;;;;;;;;;;;;;;;;;;;;;;;;;;;;;;;;;;@
@;;;;$;;;$;;;;;;@;;;;$;;;;$;;;;@;;;;;$;;;;$;;;;;@;;;;$;;;;$;;;;@;;;;;$;;;$;;;;;;@;;;;$;;;;$;;;;@;;;;;$;;;;$;;;;;@;;;;$;;;;$;;;;@
@;;;;;;;;;;;;;;;@;;;;;;;;;;;;;;@;;;;;;;;;;;;;;;;@;;;;;;;;;;;;;;@;;;;;;;;;;;;;;;;@;;;;;;;;;;;;;;@;;;;;;;;;;;;;;;;@;;;;;;;;;;;;;;@
@;;;;;;;;;;;;;;;@;;;;;;;;;;;;;;@;;;;;;;;;;;;;;;;@;;;;;;;;;;;;;;@;;;;;;;;;;;;;;;;@;;;;;;;;;;;;;;@;;;;;;;;;;;;;;;;@;;;;;;;;;;;;;;@
@;;;;@;;;@;;;;;;@;;;;@;;;;@;;;;@;;;;;@;;;;@;;;;;@;;;;@;;;;@;;;;@;;;;;@;;;@;;;;;;@;;;;@;;;;@;;;;@;;;;;@;;;;@;;;;;@;;;;@;;;;@;;;;@
@;;;;;;;;;;;;;;;@;;;;;;;;;;;;;;@;;;;;;;;;;;;;;;;@;;;;;;;;;;;;;;@;;;;;;;;;;;;;;;;@;;;;;;;;;;;;;;@;;;;;;;;;;;;;;;;@;;;;;;;;;;;;;;@
@;;;;;;;;;;;;;;;@;;;;;;;;;;;;;;@;;;;;;;;;;;;;;;;@;;;;;;;;;;;;;;@;;;;;;;;;;;;;;;;@;;;;;;;;;;;;;;@;;;;;;;;;;;;;;;;@;;;;;;;;;;;;;;@
@;;;;@;;;@;;;;;;@;;;;@;;;;@;;;;@;;;;;@;;;;@;;;;;@;;;;@;;;;@;;;;@;;;;;@;;;@;;;;;;@;;;;@;;;;@;;;;@;;;;;@;;;;@;;;;;@;;;;@;;;;@;;;;@
@;;;;;;;;;;;;;;;@;;;;;;;;;;;;;;@;;;;;;;;;;;;;;;;@;;;;;;;;;;;;;;@;;;;;;;;;;;;;;;;@;;;;;;;;;;;;;;@;;;;;;;;;;;;;;;;@;;;;;;;;;;;;;;@
@;;;;;;;;;;;;;;;@;;;;;;;;;;;;;;@;;;;;;;;;;;;;;;;@;;;;;;;;;;;;;;@;;;;;;;;;;;;;;;;@;;;;;;;;;;;;;;@;;;;;;;;;;;;;;;;@;;;;;;;;;;;;;;@
@;;;;$;;;$;;;;;;@;;;;$;;;;$;;;;@;;;;;$;;;;$;;;;;@;;;;$;;;;$;;;;@;;;;;$;;;$;;;;;;@;;;;$;;;;$;;;;@;;;;;$;;;;$;;;;;@;;;;$;;;;$;;;;@
@;;;;;;;;;;;;;;;@;;;;;;;;;;;;;;@;;;;;;;;;;;;;;;;@;;;;;;;;;;;;;;@;;;;;;;;;;;;;;;;@;;;;;;;;;;;;;;@;;;;;;;;;;;;;;;;@;;;;;;;;;;;;;;@
@;;;;;;;;;;;;;;;@;;;;;;;;;;;;;;@;;;;;;;;;;;;;;;;@;;;;;;;;;;;;;;@;;;;;;;;;;;;;;;;@;;;;;;;;;;;;;;@;;;;;;;;;;;;;;;;@;;;;;;;;;;;;;;@
@;;;;@;;;@;;;;;;@;;;;@;;;;@;;;;@;;;;;@;;;;@;;;;;@;;;;@;;;;@;;;;@;;;;;@;;;@;;;;;;@;;;;@;;;;@;;;;@;;;;;@;;;;@;;;;;@;;;;@;;;;@;;;;@
@;;;;;;;;;;;;;;;@;;;;;;;;;;;;;;@;;;;;;;;;;;;;;;;@;;;;;;;;;;;;;;@;;;;;;;;;;;;;;;;@;;;;;;;;;;;;;;@;;;;;;;;;;;;;;;;@;;;;;;;;;;;;;;@
@;;;;;;;;;;;;;;;@;;;;;;;;;;;;;;@;;;;;;;;;;;;;;;;@;;;;;;;;;;;;;;@;;;;;;;;;;;;;;;;@;;;;;;;;;;;;;;@;;;;;;;;;;;;;;;;@;;;;;;;;;;;;;;@
@;;;;@;;;@;;;;;;@;;;;@;;;;@;;;;@;;;;;@;;;;@;;;;;@;;;;@;;;;@;;;;@;;;;;@;;;@;;;;;;@;;;;@;;;;@;;;;@;;;;;@;;;;@;;;;;@;;;;@;;;;@;;;;@
@;;;;;;;;;;;;;;;@;;;;;;;;;;;;;;@;;;;;;;;;;;;;;;;@;;;;;;;;;;;;;;@;;;;;;;;;;;;;;;;@;;;;;;;;;;;;;;@;;;;;;;;;;;;;;;;@;;;;;;;;;;;;;;@
@;;;;;;;;;;;;;;;@;;;;;;;;;;;;;;@;;;;;;;;;;;;;;;;@;;;;;;;;;;;;;;@;;;;;;;;;;;;;;;;@;;;;;;;;;;;;;;@;;;;;;;;;;;;;;;;@;;;;;;;;;;;;;;@
@;;;;$;;;$;;;;;;@;;;;$;;;;$;;;;@;;;;;$;;;;$;;;;;@;;;;$;;;;$;;;;@;;;;;$;;;$;;;;;;@;;;;$;;;;$;;;;@;;;;;$;;;;$;;;;;@;;;;$;;;;$;;;;@
@;;;;;;;;;;;;;;;;;;;;;;;;;;;;;;@;;;;;;;;;;;;;;;;;;;;;;;;;;;;;;;@;;;;;;;;;;;;;;;;;;;;;;;;;;;;;;;@;;;;;;;;;;;;;;;;;;;;;;;;;;;;;;;@
@;;;;;;;;;;;;;;;;;;;;;;;;;;;;;;;;;;;;;;;;;;;;;;;;;;;;;;;;;;;;;;;;;;;;;;;;;;;;;;;;;;;;;;;;;;;;;;;;;;;;;;;;;;;;;;;;;;;;;;;;;;;;;;@
@;;;;;;;;;;;;;;;;;;;;;;;;;;;;;;;;;;;;;;;;;;;;;;;;;;;;;;;;;;;;;;;;;;;;;;;;;;;;;;;;;;;;;;;;;;;;;;;;;;;;;;;;;;;;;;;;;;;;;;;;;;;;;;@
@;;;;;;;;;;;;;;;;;;;;;;;;;;;;;;;;;;;;;;;;;;;;;;;;;;;;;;;;;;;;;;;;;;;;;;;;;;;;;;;;;;;;;;;;;;;;;;;;;;;;;;;;;;;;;;;;;;;;;;;;;;;;;;@
@;;;;;;;;;;;;;;;;;;;;;;;;;;;;;;@;;;;;;;;;;;;;;;;;;;;;;;;;;;;;;;@;;;;;;;;;;;;;;;;;;;;;;;;;;;;;;;@;;;;;;;;;;;;;;;;;;;;;;;;;;;;;;;@
@;;;;@;;;@;;;;;;$;;;;@;;;;@;;;;@;;;;;@;;;;@;;;;;$;;;;@;;;;@;;;;@;;;;;@;;;@;;;;;;$;;;;@;;;;@;;;;@;;;;;@;;;;@;;;;;$;;;;@;;;;@;;;;@
@;;;;;;;;;;;;;;;@;;;;;;;;;;;;;;@;;;;;;;;;;;;;;;;@;;;;;;;;;;;;;;@;;;;;;;;;;;;;;;;@;;;;;;;;;;;;;;@;;;;;;;;;;;;;;;;@;;;;;;;;;;;;;;@
@;;;;;;;;;;;;;;;@;;;;;;;;;;;;;;@;;;;;;;;;;;;;;;;@;;;;;;;;;;;;;;@;;;;;;;;;;;;;;;;@;;;;;;;;;;;;;;@;;;;;;;;;;;;;;;;@;;;;;;;;;;;;;;@
@;;;;@;;;@;;;;;;@;;;;@;;;;@;;;;@;;;;;@;;;;@;;;;;@;;;;@;;;;@;;;;@;;;;;@;;;@;;;;;;@;;;;@;;;;@;;;;@;;;;;@;;;;@;;;;;@;;;;@;;;;@;;;;@
@;;;;;;;;;;;;;;;@;;;;;;;;;;;;;;@;;;;;;;;;;;;;;;;@;;;;;;;;;;;;;;@;;;;;;;;;;;;;;;;@;;;;;;;;;;;;;;@;;;;;;;;;;;;;;;;@;;;;;;;;;;;;;;@
@;;;;;;;;;;;;;;;@;;;;;;;;;;;;;;@;;;;;;;;;;;;;;;;@;;;;;;;;;;;;;;@;;;;;;;;;;;;;;;;@;;;;;;;;;;;;;;@;;;;;;;;;;;;;;;;@;;;;;;;;;;;;;;@
@;;;;$;;;$;;;;;;@;;;;$;;;;$;;;;@;;;;;$;;;;$;;;;;@;;;;$;;;;$;;;;@;;;;;$;;;$;;;;;;@;;;;$;;;;$;;;;@;;;;;$;;;;$;;;;;@;;;;$;;;;$;;;;@
@;;;;;;;;;;;;;;;@;;;;;;;;;;;;;;@;;;;;;;;;;;;;;;;@;;;;;;;;;;;;;;@;;;;;;;;;;;;;;;;@;;;;;;;;;;;;;;@;;;;;;;;;;;;;;;;@;;;;;;;;;;;;;;@
@;;;;;;;;;;;;;;;@;;;;;;;;;;;;;;@;;;;;;;;;;;;;;;;@;;;;;;;;;;;;;;@;;;;;;;;;;;;;;;;@;;;;;;;;;;;;;;@;;;;;;;;;;;;;;;;@;;;;;;;;;;;;;;@
@;;;;@;;;@;;;;;;@;;;;@;;;;@;;;;@;;;;;@;;;;@;;;;;@;;;;@;;;;@;;;;@;;;;;@;;;@;;;;;;@;;;;@;;;;@;;;;@;;;;;@;;;;@;;;;;@;;;;@;;;;@;;;;@
@;;;;;;;;;;;;;;;@;;;;;;;;;;;;;;@;;;;;;;;;;;;;;;;@;;;;;;;;;;;;;;@;;;;;;;;;;;;;;;;@;;;;;;;;;;;;;;@;;;;;;;;;;;;;;;;@;;;;;;;;;;;;;;@
@;;;;;;;;;;;;;;;@;;;;;;;;;;;;;;@;;;;;;;;;;;;;;;;@;;;;;;;;;;;;;;@;;;;;;;;;;;;;;;;@;;;;;;;;;;;;;;@;;;;;;;;;;;;;;;;@;;;;;;;;;;;;;;@
@;;;;@;;;@;;;;;;@;;;;@;;;;@;;;;@;;;;;@;;;;@;;;;;@;;;;@;;;;@;;;;@;;;;;@;;;@;;;;;;@;;;;@;;;;@;;;;@;;;;;@;;;;@;;;;;@;;;;@;;;;@;;;;@
@;;;;;;;;;;;;;;;@;;;;;;;;;;;;;;@;;;;;;;;;;;;;;;;@;;;;;;;;;;;;;;@;;;;;;;;;;;;;;;;@;;;;;;;;;;;;;;@;;;;;;;;;;;;;;;;@;;;;;;;;;;;;;;@
@;;;;;;;;;;;;;;;@;;;;;;;;;;;;;;@;;;;;;;;;;;;;;;;@;;;;;;;;;;;;;;@;;;;;;;;;;;;;;;;@;;;;;;;;;;;;;;@;;;;;;;;;;;;;;;;@;;;;;;;;;;;;;;@
@;;;;$;;;$;;;;;;@;;;;$;;;;$;;;;@;;;;;$;;;;$;;;;;@;;;;$;;;;$;;;;@;;;;;$;;;$;;;;;;@;;;;$;;;;$;;;;@;;;;;$;;;;$;;;;;@;;;;$;;;;$;;;;@
@;;;;;;;;;;;;;;;@;;;;;;;;;;;;;;@;;;;;;;;;;;;;;;;@;;;;;;;;;;;;;;@;;;;;;;;;;;;;;;;@;;;;;;;;;;;;;;@;;;;;;;;;;;;;;;;@;;;;;;;;;;;;;;@
@;;;;;;;;;;;;;;;@;;;;;;;;;;;;;;@;;;;;;;;;;;;;;;;@;;;;;;;;;;;;;;@;;;;;;;;;;;;;;;;@;;;;;;;;;;;;;;@;;;;;;;;;;;;;;;;@;;;;;;;;;;;;;;@
@;;;;@;;;@;;;;;;$;;;;@;;;;@;;;;@;;;;;@;;;;@;;;;;$;;;;@;;;;@;;;;$;;;;;@;;;@;;;;;;$;;;;@;;;;@;;;;@;;;;;@;;;;@;;;;;$;;;;@;;;;@;;;;@
@;;;;;;;;;;;;;;;;;;;;;;;;;;;;;;@;;;;;;;;;;;;;;;;;;;;;;;;;;;;;;;;;;;;;;;;;;;;;;;;;;;;;;;;;;;;;;;@;;;;;;;;;;;;;;;;;;;;;;;;;;;;;;;@
@;;;;;;;;;;;;;;;;;;;;;;;;;;;;;;@;;;;;;;;;;;;;;;;;;;;;;;;;;;;;;;;;;;;;;;;;;;;;;;;;;;;;;;;;;;;;;;@;;;;;;;;;;;;;;;;;;;;;;;;;;;;;;;@
@@@@@@@@@@$;;;;;;;;;;;$@@@@@@@@@@@@@@@@@@@$;;;;;;;;;;;$@@@@@@@@@@@@@@@@@@@$;;;;;;;;;;;$@@@@@@@@@@@@@@@@@@@$;;;;;;;;;;;$@@@@@@@@@
@;;;;;;;;;;;;;;;;;;;;;;;;;;;;;;;;;;;;;;;;;;;;;;;;;;;;;;;;;;;;;;;;;;;;;;;;;;;;;;;;;;;;;;;;;;;;;;;;;;;;;;;;;;;;;;;;;;;;;;;;;;;;;;@
@;;;;;;;;;;;;;;;;;;;;;;;;;;;;;;;;;;;;;;;;;;;;;;;;;;;;;;;;;;;;;;;;;;;;;;;;;;;;;;;;;;;;;;;;;;;;;;;;;;;;;;;;;;;;;;;;;;;;;;;;;;;;;;@
@;;;;;;;;;;;;;;;;;;;;;;;;;;;;;;;;;;;;;;;;;;;;;;;;;;;;;;;;;;;;;;;;;;;;;;;;;;;;;;;;;;;;;;;;;;;;;;;;;;;;;;;;;;;;;;;;;;;;;;;;;;;;;;@
@;;;;@;;;@;;;;;;$;;;;@;;;;@;;;;$;;;;;@;;;;@;;;;;$;;;;@;;;;@;;;;$;;;;;@;;;@;;;;;;$;;;;@;;;;@;;;;$;;;;;@;;;;@;;;;;$;;;;@;;;;@;;;;@
@;;;;;;;;;;;;;;;@;;;;;;;;;;;;;;@;;;;;;;;;;;;;;;;@;;;;;;;;;;;;;;@;;;;;;;;;;;;;;;;@;;;;;;;;;;;;;;@;;;;;;;;;;;;;;;;@;;;;;;;;;;;;;;@
@;;;;;;;;;;;;;;;@;;;;;;;;;;;;;;@;;;;;;;;;;;;;;;;@;;;;;;;;;;;;;;@;;;;;;;;;;;;;;;;@;;;;;;;;;;;;;;@;;;;;;;;;;;;;;;;@;;;;;;;;;;;;;;@
@;;;;@;;;@;;;;;;@;;;;@;;;;@;;;;@;;;;;@;;;;@;;;;;@;;;;@;;;;@;;;;@;;;;;@;;;@;;;;;;@;;;;@;;;;@;;;;@;;;;;@;;;;@;;;;;@;;;;@;;;;@;;;;@
@;;;;;;;;;;;;;;;@;;;;;;;;;;;;;;@;;;;;;;;;;;;;;;;@;;;;;;;;;;;;;;@;;;;;;;;;;;;;;;;@;;;;;;;;;;;;;;@;;;;;;;;;;;;;;;;@;;;;;;;;;;;;;;@
@;;;;;;;;;;;;;;;@;;;;;;;;;;;;;;@;;;;;;;;;;;;;;;;@;;;;;;;;;;;;;;@;;;;;;;;;;;;;;;;@;;;;;;;;;;;;;;@;;;;;;;;;;;;;;;;@;;;;;;;;;;;;;;@
@;;;;$;;;$;;;;;;@;;;;$;;;;$;;;;@;;;;;$;;;;$;;;;;@;;;;$;;;;$;;;;@;;;;;$;;;$;;;;;;@;;;;$;;;;$;;;;@;;;;;$;;;;$;;;;;@;;;;$;;;;$;;;;@
@;;;;;;;;;;;;;;;@;;;;;;;;;;;;;;@;;;;;;;;;;;;;;;;@;;;;;;;;;;;;;;@;;;;;;;;;;;;;;;;@;;;;;;;;;;;;;;@;;;;;;;;;;;;;;;;@;;;;;;;;;;;;;;@
@;;;;;;;;;;;;;;;@;;;;;;;;;;;;;;@;;;;;;;;;;;;;;;;@;;;;;;;;;;;;;;@;;;;;;;;;;;;;;;;@;;;;;;;;;;;;;;@;;;;;;;;;;;;;;;;@;;;;;;;;;;;;;;@
@;;;;@;;;@;;;;;;@;;;;@;;;;@;;;;@;;;;;@;;;;@;;;;;@;;;;@;;;;@;;;;@;;;;;@;;;@;;;;;;@;;;;@;;;;@;;;;@;;;;;@;;;;@;;;;;@;;;;@;;;;@;;;;@
@;;;;;;;;;;;;;;;@;;;;;;;;;;;;;;@;;;;;;;;;;;;;;;;@;;;;;;;;;;;;;;@;;;;;;;;;;;;;;;;@;;;;;;;;;;;;;;@;;;;;;;;;;;;;;;;@;;;;;;;;;;;;;;@
@;;;;;;;;;;;;;;;@;;;;;;;;;;;;;;@;;;;;;;;;;;;;;;;@;;;;;;;;;;;;;;@;;;;;;;;;;;;;;;;@;;;;;;;;;;;;;;@;;;;;;;;;;;;;;;;@;;;;;;;;;;;;;;@
@;;;;@;;;@;;;;;;@;;;;@;;;;@;;;;;;;;;;@;;;;@;;;;;;;;;;@;;;;@;;;;@;;;;;@;;;@;;;;;;@;;;;@;;;;@;;;;;;;;;;@;;;;@;;;;;;;;;;@;;;;@;;;;@
@;;;;;;;;;;;;;;;@;;;;;;;;;;;;;;;;;;;;;;;;;;;;;;;;;;;;;;;;;;;;;;@;;;;;;;;;;;;;;;;;;;;;;;;;;;;;;;;;;;;;;;;;;;;;;;;;;;;;;;;;;;;;;;@
@;;;;;;;;;;;;;;;@;;;;;;;;;;;;;;;;;;;;;;;;;;;;;;;;;;;;;;;;;;;;;;@;;;;;;;;;;;;;;;;;;;;;;;;;;;;;;;;;;;;;;;;;;;;;;;;;;;;;;;;;;;;;;;@
@;;;;$;;;$;;;;;;@;;;;$;;;;$;;;;@;;;;;$;;;;$;;;;;@;;;;$;;;;$;;;;@;;;;;$;;;$;;;;;;@;;;;$;;;;$;;;;@;;;;;$;;;;$;;;;;@;;;;$;;;;$;;;;@
@;;;;;;;;;;;;;;;@;;;;;;;;;;;;;;@;;;;;;;;;;;;;;;;@;;;;;;;;;;;;;;@;;;;;;;;;;;;;;;;@;;;;;;;;;;;;;;@;;;;;;;;;;;;;;;;@;;;;;;;;;;;;;;@
@;;;;;;;;;;;;;;;@;;;;;;;;;;;;;;@;;;;;;;;;;;;;;;;@;;;;;;;;;;;;;;@;;;;;;;;;;;;;;;;@;;;;;;;;;;;;;;@;;;;;;;;;;;;;;;;@;;;;;;;;;;;;;;@
@;;;;@;;;@;;;;;;@;;;;@;;;;@;;;;@;;;;;@;;;;@;;;;;@;;;;@;;;;@;;;;@;;;;;@;;;@;;;;;;@;;;;@;;;;@;;;;@;;;;;@;;;;@;;;;;@;;;;@;;;;@;;;;@
@;;;;;;;;;;;;;;;@;;;;;;;;;;;;;;@;;;;;;;;;;;;;;;;@;;;;;;;;;;;;;;@;;;;;;;;;;;;;;;;@;;;;;;;;;;;;;;@;;;;;;;;;;;;;;;;@;;;;;;;;;;;;;;@
@;;;;;;;;;;;;;;;@;;;;;;;;;;;;;;@;;;;;;;;;;;;;;;;@;;;;;;;;;;;;;;@;;;;;;;;;;;;;;;;@;;;;;;;;;;;;;;@;;;;;;;;;;;;;;;;@;;;;;;;;;;;;;;@
@;;;;@;;;@;;;;;;@;;;;@;;;;@;;;;@;;;;;@;;;;@;;;;;@;;;;@;;;;@;;;;@;;;;;@;;;@;;;;;;@;;;;@;;;;@;;;;@;;;;;@;;;;@;;;;;@;;;;@;;;;@;;;;@
@;;;;;;;;;;;;;;;@;;;;;;;;;;;;;;@;;;;;;;;;;;;;;;;@;;;;;;;;;;;;;;@;;;;;;;;;;;;;;;;@;;;;;;;;;;;;;;@;;;;;;;;;;;;;;;;@;;;;;;;;;;;;;;@
@;;;;;;;;;;;;;;;@;;;;;;;;;;;;;;@;;;;;;;;;;;;;;;;@;;;;;;;;;;;;;;@;;;;;;;;;;;;;;;;@;;;;;;;;;;;;;;@;;;;;;;;;;;;;;;;@;;;;;;;;;;;;;;@
@;;;;$;;;$;;;;;;@;;;;$;;;;$;;;;@;;;;;$;;;;$;;;;;@;;;;$;;;;$;;;;@;;;;;$;;;$;;;;;;@;;;;$;;;;$;;;;@;;;;;$;;;;$;;;;;@;;;;$;;;;$;;;;@
@;;;;;;;;;;;;;;;@;;;;;;;;;;;;;;@;;;;;;;;;;;;;;;;@;;;;;;;;;;;;;;@;;;;;;;;;;;;;;;;@;;;;;;;;;;;;;;@;;;;;;;;;;;;;;;;@;;;;;;;;;;;;;;@
@;;;;;;;;;;;;;;;@;;;;;;;;;;;;;;@;;;;;;;;;;;;;;;;@;;;;;;;;;;;;;;@;;;;;;;;;;;;;;;;@;;;;;;;;;;;;;;@;;;;;;;;;;;;;;;;@;;;;;;;;;;;;;;@
@;;;;@;;;@;;;;;;@;;;;@;;;;@;;;;@;;;;;@;;;;@;;;;;@;;;;@;;;;@;;;;@;;;;;@;;;@;;;;;;@;;;;@;;;;@;;;;@;;;;;@;;;;@;;;;;@;;;;@;;;;@;;;;@
@;;;;;;;;;;;;;;;@;;;;;;;;;;;;;;@;;;;;;;;;;;;;;;;@;;;;;;;;;;;;;;@;;;;;;;;;;;;;;;;@;;;;;;;;;;;;;;@;;;;;;;;;;;;;;;;@;;;;;;;;;;;;;;@
@;;;;;;;;;;;;;;;@;;;;;;;;;;;;;;@;;;;;;;;;;;;;;;;@;;;;;;;;;;;;;;@;;;;;;;;;;;;;;;;@;;;;;;;;;;;;;;@;;;;;;;;;;;;;;;;@;;;;;;;;;;;;;;@
@;;;;@;;;@;;;;;;@;;;;@;;;;@;;;;@;;;;;@;;;;@;;;;;@;;;;@;;;;@;;;;@;;;;;@;;;@;;;;;;@;;;;@;;;;@;;;;@;;;;;@;;;;@;;;;;@;;;;@;;;;@;;;;@
@;;;;;;;;;;;;;;;@;;;;;;;;;;;;;;@;;;;;;;;;;;;;;;;@;;;;;;;;;;;;;;@;;;;;;;;;;;;;;;;@;;;;;;;;;;;;;;@;;;;;;;;;;;;;;;;@;;;;;;;;;;;;;;@
@;;;;;;;;;;;;;;;@;;;;;;;;;;;;;;@;;;;;;;;;;;;;;;;@;;;;;;;;;;;;;;@;;;;;;;;;;;;;;;;@;;;;;;;;;;;;;;@;;;;;;;;;;;;;;;;@;;;;;;;;;;;;;;@
@;;;;$;;;$;;;;;;@;;;;$;;;;$;;;;@;;;;;$;;;;$;;;;;@;;;;$;;;;$;;;;@;;;;;$;;;$;;;;;;@;;;;$;;;;$;;;;@;;;;;$;;;;$;;;;;@;;;;$;;;;$;;;;@
@;;;;;;;;;;;;;;;;;;;;;;;;;;;;;;;;;;;;;;;;;;;;;;;;;;;;;;;;;;;;;;;;;;;;;;;;;;;;;;;;;;;;;;;;;;;;;;;;;;;;;;;;;;;;;;;;;;;;;;;;;;;;;;@
@;;;;;;;;;;;;;;;;;;;;;;;;;;;;;;;;;;;;;;;;;;;;;;;;;;;;;;;;;;;;;;;;;;;;;;;;;;;;;;;;;;;;;;;;;;;;;;;;;;;;;;;;;;;;;;;;;;;;;;;;;;;;;;@
@;;;;;;;;;;;;;;;$;;;;;;;;;;;;;;$;;;;;;;;;;;;;;;;$;;;;;;;;;;;;;;$;;;;;;;;;;;;;;;;$;;;;;;;;;;;;;;$;;;;;;;;;;;;;;;;$;;;;;;;;;;;;;;@
@;;;;;;;;;;;;;;;;;;;;;;;;;;;;;;;;;;;;;;;;;;;;;;;;;;;;;;;;;;;;;;;;;;;;;;;;;;;;;;;;;;;;;;;;;;;;;;;;;;;;;;;;;;;;;;;;;;;;;;;;;;;;;;@
@;;;;;;;;;;;;;;;;;;;;;;;;;;;;;;;;;;;;;;;;;;;;;;;;;;;;;;;;;;;;;;;;;;;;;;;;;;;;;;;;;;;;;;;;;;;;;;;;;;;;;;;;;;;;;;;;;;;;;;;;;;;;;;@
@;;;;@;;;@;;;;;;$;;;;@;;;;@;;;;$;;;;;@;;;;@;;;;;$;;;;@;;;;@;;;;$;;;;;@;;;@;;;;;;$;;;;@;;;;@;;;;$;;;;;@;;;;@;;;;;$;;;;@;;;;@;;;;@
@;;;;;;;;;;;;;;;;;;;;;;;;;;;;;;;;;;;;;;;;;;;;;;;;;;;;;;;;;;;;;;@;;;;;;;;;;;;;;;;;;;;;;;;;;;;;;;;;;;;;;;;;;;;;;;;;;;;;;;;;;;;;;;@
@;;;;;;;;;;;;;;;;;;;;;;;;;;;;;;;;;;;;;;;;;;;;;;;;;;;;;;;;;;;;;;@;;;;;;;;;;;;;;;;;;;;;;;;;;;;;;;;;;;;;;;;;;;;;;;;;;;;;;;;;;;;;;;@
@;;;;@;;;@;;;;;;@;;;;@;;;;@;;;;@;;;;;@;;;;@;;;;;@;;;;@;;;;@;;;;@;;;;;@;;;@;;;;;;@;;;;@;;;;@;;;;@;;;;;@;;;;@;;;;;@;;;;@;;;;@;;;;@
@;;;;;;;;;;;;;;;;;;;;;;;;;;;;;;;;;;;;;;;;;;;;;;;;;;;;;;;;;;;;;;@;;;;;;;;;;;;;;;;;;;;;;;;;;;;;;;;;;;;;;;;;;;;;;;;;;;;;;;;;;;;;;;@
@;;;;;;;;;;;;;;;;;;;;;;;;;;;;;;;;;;;;;;;;;;;;;;;;;;;;;;;;;;;;;;@;;;;;;;;;;;;;;;;;;;;;;;;;;;;;;;;;;;;;;;;;;;;;;;;;;;;;;;;;;;;;;;@
@;;;;$;;;$;;;;;;@;;;;$;;;;$;;;;@;;;;;$;;;;$;;;;;@;;;;$;;;;$;;;;@;;;;;$;;;$;;;;;;@;;;;$;;;;$;;;;@;;;;;$;;;;$;;;;;@;;;;$;;;;$;;;;@
@;;;;;;;;;;;;;;;;;;;;;;;;;;;;;;;;;;;;;;;;;;;;;;;;;;;;;;;;;;;;;;@;;;;;;;;;;;;;;;;;;;;;;;;;;;;;;;;;;;;;;;;;;;;;;;;;;;;;;;;;;;;;;;@
@;;;;;;;;;;;;;;;;;;;;;;;;;;;;;;;;;;;;;;;;;;;;;;;;;;;;;;;;;;;;;;@;;;;;;;;;;;;;;;;;;;;;;;;;;;;;;;;;;;;;;;;;;;;;;;;;;;;;;;;;;;;;;;@
@;;;;@;;;@;;;;;;@;;;;@;;;;@;;;;@;;;;;@;;;;@;;;;;@;;;;@;;;;@;;;;@;;;;;@;;;@;;;;;;@;;;;@;;;;@;;;;@;;;;;@;;;;@;;;;;@;;;;@;;;;@;;;;@
@;;;;;;;;;;;;;;;;;;;;;;;;;;;;;;;;;;;;;;;;;;;;;;;;;;;;;;;;;;;;;;@;;;;;;;;;;;;;;;;;;;;;;;;;;;;;;;;;;;;;;;;;;;;;;;;;;;;;;;;;;;;;;;@
@;;;;;;;;;;;;;;;;;;;;;;;;;;;;;;;;;;;;;;;;;;;;;;;;;;;;;;;;;;;;;;@;;;;;;;;;;;;;;;;;;;;;;;;;;;;;;;;;;;;;;;;;;;;;;;;;;;;;;;;;;;;;;;@
@;;;;@;;;@;;;;;;@;;;;@;;;;@;;;;@;;;;;@;;;;@;;;;;@;;;;@;;;;@;;;;@;;;;;@;;;@;;;;;;@;;;;@;;;;@;;;;@;;;;;@;;;;@;;;;;@;;;;@;;;;@;;;;@
@;;;;;;;;;;;;;;;;;;;;;;;;;;;;;;;;;;;;;;;;;;;;;;;;;;;;;;;;;;;;;;@;;;;;;;;;;;;;;;;;;;;;;;;;;;;;;;;;;;;;;;;;;;;;;;;;;;;;;;;;;;;;;;@
@;;;;;;;;;;;;;;;;;;;;;;;;;;;;;;;;;;;;;;;;;;;;;;;;;;;;;;;;;;;;;;@;;;;;;;;;;;;;;;;;;;;;;;;;;;;;;;;;;;;;;;;;;;;;;;;;;;;;;;;;;;;;;;@
@;;;;$;;;$;;;;;;@;;;;$;;;;$;;;;@;;;;;$;;;;$;;;;;@;;;;$;;;;$;;;;@;;;;;$;;;$;;;;;;@;;;;$;;;;$;;;;@;;;;;$;;;;$;;;;;@;;;;$;;;;$;;;;@
@;;;;;;;;;;;;;;;;;;;;;;;;;;;;;;;;;;;;;;;;;;;;;;;;;;;;;;;;;;;;;;@;;;;;;;;;;;;;;;;;;;;;;;;;;;;;;;;;;;;;;;;;;;;;;;;;;;;;;;;;;;;;;;@
@;;;;;;;;;;;;;;;;;;;;;;;;;;;;;;;;;;;;;;;;;;;;;;;;;;;;;;;;;;;;;;@;;;;;;;;;;;;;;;;;;;;;;;;;;;;;;;;;;;;;;;;;;;;;;;;;;;;;;;;;;;;;;;@
@@@@@@@@@@@@@@@@@@@@@@@@@@@@@@@@@@@@@@@@@@@@@@@@@@@@@@@@@@@@@@@@@@@@@@@@@@@@@@@@@@@@@@@@@@@@@@@@@@@@@@@@@@@@@@@@@@@@@@@@@@@@S@@@
@%%%%%%%%%%%%%%%%%%%%%%%%%%%%%%%%%%%%%%%%%%%%%%%%%%%%%%%%%%%%%%%%%%%%%%%%%%%%%%%%%%%%%%%%%%%%%%%%%%%%%%%%%%%%%%%%%%%%%%%%%%%D%%@
D;;;;;;;;;;;;;;;;;;;;;;;;;;;;;;;;;;;;;;;;;;;;;;;;;;;;;;;;;;;;;;;;;;;;;;;;;;;;;;;;;;;;;;;;;;;;;;;;;;;;;;;;;;;;;;;;;;;;;;;;;;;;;;%
%%%%%%%%%%%%%%%%%%%%%%%%%%%%%%%%%%%%%%%%%%%%%%%%%%%%%%%%%%%%%%%%%%%%%%%%%%%%%%%%%%%%%%%%%%%%%%%%%%%%%%%%%%%%%%%%%%%%%%%%%%%%%%%%