#@##############################################################
#.#............................................................#
@.@............................................................#
#.#............................................................#
@.@............................................................#
#.#............................................................#
@.@............................................................#
#.#............................................................#
@.@............................................................#
#.#............................................................#
@.@............................................................#
#.#............................................................#
@.@............................................................#
#.#............................................................#
@.@............................................................#
#.#............................................................#
@.@............................................................#
#.#............................................................#
@.@............................................................#
#.#............................................................#
@.@............................................................#
#.#............................................................#
@.@............................................................#
#.#............................................................#
@.@............................................................#
#.#............................................................#
@.@............................................................#
#.#............................................................#
@.@............................................................#
#.#............................................................#
@.@............................................................#
#.#............................................................#
@.@............................................................#
#.#............................................................#
@.@............................................................#
#.#............................................................#
@.@............................................................#
#.#............................................................#
@.@............................................................#
#.#............................................................#
@.@............................................................#
#.#............................................................#
@.@............................................................#
#.#............................................................#
@.@............................................................#
#.#............................................................#
@.@............................................................#
#.#............................................................#
@.@............................................................#
#.#............................................................#
@.@............................................................#
#.#............................................................#
@.@............................................................#
#.#............................................................#
@.@............................................................#
#.#............................................................#
@.@............................................................#
#.#............................................................#
@.@............................................................#
#.#............................................................#
@.@............................................................#
#.#............................................................#
@.@............................................................#
#@##############################################################