&A&&&&&W&&&&&&&&&&&&&&&&&&&&W&&&&&&&&&&&&&&&&&&&&&&&&&&&&&&&&&&&&W&&&&&&&&&&&&&&&&&&&&&&&&&&&&&&&&&&&&&&&&&&&&&&&&&&&&&&&&&&&&&&
&;&;;;&;&;;&;&WWWWWWWWWWWWW&;&;;;;;;;;;;;;;;;;;;;;;;;&;&;;;;;;;;;;;;;;;;;;;;;;;;;;;;;;;;;;;;;;;;;;;;;;;;;;;;;;;;;;;;;;;;;;;;;;;&
&;&;;;&;&;;&;&W;;;;;;;;;;;;&;&;;;;;;;;;;;;;;;;;;;;;;;&;&;;;;;;;;;;;;;;;;;;;;;;;;;;;;;;;;;;;;;;;;;;;;;;;;;;;;;;;;;;;;;;;;;;;;;;;&
&;&;;;&;&;;&;&W;;;;;;;;;;;;&;&;;;;;;;;;;;;;;;;;;;;;;;&;&;;;;;;;;;;;;;;;;;;;;;;;;;;;;;;;;;;;;;;;;;;;;;;;;;;;;;;;;;;;;;;;;;;;;;;;&
&;&;;;&;&;;&;&W;;;;;;;;;;;;;;&;;;;;;;;;;;;;;;;;;;;;;;&;&;;;;;;;;;;;;;;;;;;;;;;;;;;;;;;;;;;;;;;;;;;;;;;;;;;;;;;;;;;;;;;;;;;;;;;;&
&;&;;;&;&;;&;&W;;;;;;;;;;;;&;&&&&&&&&&&&&&&&&&&&&&&&&&;&;;;;;;;;;;;;;;;;;;;;;;;;;;;;;;;;;;;;;;;;;;;;;;;;;;;;;;;;;;;;;;;;;;;;;;;&
&;&&&&&;&;;&;&W;;;;;;;;;;;;&;;;;;;;;;;;;;;;;;;;;;;;;;;;&;;;;;;;;;;;;;;;;;;;;;;;;;;;;;;;;;;;;;;;;;;;;;;;;;;;;;;;;;;;;;;;;;;;;;;;&
&;;;;;;;&;;&;&W;;;;;;;;;;;;&;&&&&&&&&&&&&&&&&&&&&&&&&&;&;;;;;;;;;;;;;;;;;;;;;;;;;;;;;;;;;;;;;;;;;;;;;;;;;;;;;;;;;;;;;;;;;;;;;;;&
&;&&&&&;&;;&;&W;;;;;;;;;;;;&;&;;;;;;;;;;;;;;;;;;;;;;;&;&;;;;;;;;;;;;;;;;;;;;;;;;;;;;;;;;;;;;;;;;;;;;;;;;;;;;;;;;;;;;;;;;;;;;;;;&
&;&;;;&;&;;&;&W;;;;;;;;;;;;&;&;;;;;;;;;;;;;;;;;;;;;;;&;&;;;;;;;;;;;;;;;;;;;;;;;;;;;;;;;;;;;;;;;;;;;;;;;;;;;;;;;;;;;;;;;;;;;;;;;&
&;&;;;&;&;;&;&W;;;;;;;;;;;;&;&;;;;;;;;;;;;;;;;;;;;;;;&;&;;;;;;;;;;;;;;;;;;;;;;;;;;;;;;;;;;;;;;;;;;;;;;;;;;;;;;;;;;;;;;;;;;;;;;;&
&;&;;;&;&;;&;&WWWWWWWWWWWWW&;&;;;;;;;;;;;;;;;;;;;;;;;&;&;;;;;;;;;;;;;;;;;;;;;;;;;;;;;;;;;;;;;;;;;;;;;;;;;;;;;;;;;;;;;;;;;;;;;;;&
&;&;;;&;&;;&;&&&&&&&&&&&&&&&;&;;;;;;;;;;;;;;;;;;;;;;;&;&;;;;;;;;;;;;;;;;;;;;;;;;;;;;;;;;;;;;;;;;;;;;;;;;;;;;;;;;;;;;;;;;;;;;;;;&
&;&;;;&;&;;&;;;;;;;;;;;;;;;;;&;;;;;;;;;;;;;;;;;;;;;;;&;&;;;;;;;;;;;;;;;;;;;;;;;;;;;;;;;;;;;;;;;;;;;;;;;;;;;;;;;;;;;;;;;;;;;;;;;&
&;&;;;&;&&&&&&&&&&&&&&&&&)W;;&;;;;;;;;;;;;;;;;;;;;;;;&;&;;;;;;;;;;;;;;;;;;;;;;;;;;;;;;;;;;;;;;;;;;;;;;;;;;;;;;;;;;;;;;;;;;;;;;;&
&;&;;;&;;;;;;;;;;;;;;;;;;;W;;&;;;;;;;;;;;;;;;;;;;;;;;&;&;;;;;;;;;;;;;;;;;;;;;;;;;;;;;;;;;;;;;;;;;;;;;;;;;;;;;;;;;;;;;;;;;;;;;;;&
&;&&&&&;&&&&&&&&&&&&&&&&&(W;;&&&&&&&&&&&&&&&&&&&&&&&&&;&&&&&&&&&&&&&&&&&&&&&&&&&&&&&&&&&&&&&&&&&&&&&&&&&&&&&&&&&&&&&&&&&&&&&&&&&
&;;;;;;;&;;;;;;;;;;;;;;;;;W;;;;;;;;;;;;;;;;;;;;;;;;;;;;;;;;;;;;;;;;;;;;;;;;;;;;;;;;;;;;;;;;;;;;;;;;;;;;;;;;;;;;;;;;;;;;;;;;;;;;&
&;&&&&&;&&&&&&&&&&&&&&&&&&);;&&&&&&&&;&&&&&&&&&&;&&&&&;&&&&&&&&&&&&&&&&&&&&&&&&&&&&&&&&&&;&&&&&&&&&&&&&&&&&&&&&;&&&&&&&&&&&&&&&&
&;&;;;&;;;;;;;;;;;;;;;;;;;&;;&WWWWWW&;&WWWWWWWW&;&;;;&;&;;;;;;;;;;;;;;;;;;;;;;;;;;;;;;;;&;&;;;;;;;;;;;;;;;;;;;&;&;;;;;;;;;;;;;;&
&;&;;;&;&&&&&&&&&&&&&&&&&;&;;&W;;;;;;;;;;;;;;;W&;&;;;&;&;;;;;;;;;;;;;;;;;;;;;;;;;;;;;;;;&;&;;;;;;;;;;;;;;;;;;;&;&;;;;;;;;;;;;;;&
&;&;;;&;&;;;;;;;;;;;;;;;&;&;;&W;;;;;;;;;;;;;;;W&;&;;;&;&;;;;;;;;;;;;;;;;;;;;;;;;;;;;;;;;&;&;;;;;;;;;;;;;;;;;;;&;&;;;;;;;;;;;;;;&
&;&;;;&;&;;;;;;;;;;;;;;;&;&;;&W;;;;;;;;;;;;;;;W&;&;;;&;&;;;;;;;;;;;;;;;;;;;;;;;;;;;;;;;;&;&;;;;;;;;;;;;;;;;;;;&;&;;;;;;;;;;;;;;&
&;&;;;&;&;;;;;;;;;;;;;;;&;&;;&W;;;;;;;;;;;;;;;W&;&;;;&;&;;;;;;;;;;;;;;;;;;;;;;;;;;;;;;;;&;&;;;;;;;;;;;;;;;;;;;&;&;;;;;;;;;;;;;;&
&;&;;;&;&;;;;;;;;;;;;;;;&;&;;&W;;;;;;;;;;;;;;;W&;&;;;&;&;;;;;;;;;;;;;;;;;;;;;;;;;;;;;;;;&;&;;;;;;;;;;;;;;;;;;;&;&;;;;;;;;;;;;;;&
&;&;;;&;&;;;;;;;;;;;;;;;&;&;;&W;;;;;;;;;;;;;;;&&;&;;;&;&;;;;;;;;;;;;;;;;;;;;;;;;;;;;;;;;&;&;;;;;;;;;;;;;;;;;;;&;&;;;;;;;;;;;;;;&
&;&;;;&;&;;;;;;;;;;;;;;;&;&;;&W;;;;;;;;;;;;;;;;;;&;;;&;&;;;;;;;;;;;;;;;;;;;;;;;;;;;;;;;;&;&;;;;;;;;;;;;;;;;;;;&;&;;;;;;;;;;;;;;&
&;&;;;&;&;;;;;;;;;;;;;;;&;&;;&W;;;;;;;;;;;;;;;&&;&;;;&;&;;;;;;;;;;;;;;;;;;;;;;;;;;;;;;;;&;&;;;;;;;;;;;;;;;;;;;&;&;;;;;;;;;;;;;;&
&;&;;;&;&;;;;;;;;;;;;;;;&;&;;&W;;;;;;;;;;;;;;;W&;&;;;&;&;;;;;;;;;;;;;;;;;;;;;;;;;;;;;;;;&;&;;;;;;;;;;;;;;;;;;;&;&;;;;;;;;;;;;;;&
&;&;;;&;&;;;;;;;;;;;;;;;&;&;;&W;;;;;;;;;;;;;;;W&;&;;;&;&;;;;;;;;;;;;;;;;;;;;;;;;;;;;;;;;&;&;;;;;;;;;;;;;;;;;;;&;&;;;;;;;;;;;;;;&
&;&;;;&;&;;;;;;;;;;;;;;;&;&;;&W;;;;;;;;;;;;;;;W&;&;;;&;&;;;;;;;;;;;;;;;;;;;;;;;;;;;;;;;;&;&;;;;;;;;;;;;;;;;;;;&;&;;;;;;;;;;;;;;&
&;&;;;&;&;;;;;;;;;;;;;;;&;&;;&W;;;;;;;;;;;;;;;W&;&;;;&;&;;;;;;;;;;;;;;;;;;;;;;;;;;;;;;;;&;&;;;;;;;;;;;;;;;;;;;&;&;;;;;;;;;;;;;;&
&;&;;;&;&;;;;;;;;;;;;;;;&;&;;&WWWWWWWWWWWWWWWWW&;&;;;&;&;;;;;;;;;;;;;;;;;;;;;;;;;;;;;;;;&;&;;;;;;;;;;;;;;;;;;;&;&;;;;;;;;;;;;;;&
&;&;;;&;&;;;;;;;;;;;;;;;&;&;;&&&&&&&&&&&&&&&&&&&;&;;;&;&;;;;;;;;;;;;;;;;;;;;;;;;;;;;;;;;&;&;;;;;;;;;;;;;;;;;;;&;&;;;;;;;;;;;;;;&
&;&;;;&;&;;;;;;;;;;;;;;;&;;;;;;;;;;;;;;;;;;;;;;;;&;;;&;&;;;;;;;;;;;;;;;;;;;;;;;;;;;;;;;;&;&;;;;;;;;;;;;;;;;;;;&;&;;;;;;;;;;;;;;&
&;&;;;&;&;;;;;;;;;;;;;;;&&&&&&&&&&&&;&&&&&&&&&&&&&;;;&;&;;;;;;;;;;;;;;;;;;;;;;;;;;;;;;;;&;&;;;;;;;;;;;;;;;;;;;&;&;;;;;;;;;;;;;;&
&;&;;;&;&;;;;;;;;;;;;;;;;;;;;;;;;;;&;&;;;;;;;;;;;;;;;&;&;;;;;;;;;;;;;;;;;;;;;;;;;;;;;;;;&;&;;;;;;;;;;;;;;;;;;;&;&;;;;;;;;;;;;;;&
&;&;;;&;&;;;;;;;;;;;;;;;;;;;;;;;;;;&;&;;;;;;;;;;;;;;;&;&&&&&&&&&&&&&&&&&&&&&&&&&&&&&&&&&&;&&&&&&&&&&&&&&&&&&&&&;&;;;;;;;;;;;;;;&
&;&;;;&;&;;;;;;;;;;;;;;;;;;;;;;;;;;&;&;;;;;;;;;;;;;;;&;;;;;;;;;;;;;;;;;;;;;;;;;;;;;;;;;;&;;;;;;;;;;;;;;;;;;;;;;;&;;;;;;;;;;;;;;&
&;&;;;&;&;;;;;;;;;;;;;;;;;;;;;;;;;;&;&;;;;;;;;;;;;;;;&;&&&&&&&&&&&&&&&&&&&&&&&&&&&&&&&&;&;&&&&&&&&;&&&&&&&&&&;&;&;;;;;;;;;;;;;;&
&;&;;;&;&;;;;;;;;;;;;;;;;;;;;;;;;;;&;&;;;;;;;;;;;;;;;&;&;;;;;;;;;;;;;;;;;;;;;;;;;;;;;;&;&;&WWWWWW&;&WWWWWWWW&;&;&;;;;;;;;;;;;;;&
&;&;;;&;&;;;;;;;;;;;;;;;;;;;;;;;;;;&;&;;;;;;;;;;;;;;;&;&;;;;;;;;;;;;;;;;;;;;;;;;;;;;;;&;&;&W;;;;;;;;;;;;;;;W&;&;&;;;;;;;;;;;;;;&
&;&;;;&;&;;;;;;;;;;;;;;;;;;;;;;;;;;&;&;;;;;;;;;;;;;;;&;&;;;;;;;;;;;;;;;;;;;;;;;;;;;;;;&;&;&W;;;;;;;;;;;;;;;W&;&;&;;;;;;;;;;;;;;&
&;&;;;&;&;;;;;;;;;;;;;;;;;;;;;;;;;;&;&;;;;;;;;;;;;;;;&;&;;;;;;;;;;;;;;;;;;;;;;;;;;;;;;&;&;&W;;;;;;;;;;;;;;;W&;&;&;;;;;;;;;;;;;;&
&;&;;;&;&;;;;;;;;;;;;;;;;;;;;;;;;;;&;&;;;;;;;;;;;;;;;&;&;;;;;;;;;;;;;;;;;;;;;;;;;;;;;;&;&;&W;;;;;;;;;;;;;;;W&;&;&;;;;;;;;;;;;;;&
&;&;;;&;&;;;;;;;;;;;;;;;;;;;;;;;;;;&;&;;;;;;;;;;;;;;;&;&;;;;;;;;;;;;;;;;;;;;;;;;;;;;;;&;&;&W;;;;;;;;;;;;;;;W&;&;&;;;;;;;;;;;;;;&
&;&;;;&;&;;;;;;;;;;;;;;;;;;;;;;;;;;&;&;;;;;;;;;;;;;;;&;&;;;;;;;;;;;;;;;;;;;;;;;;;;;;;;&;&;&W;;;;;;;;;;;;;;;&&;&;&;;;;;;;;;;;;;;&
&;&;;;&;&;;;;;;;;;;;;;;;;;;;;;;;;;;&;&WWWW;;;;;;;;;;;&;&;;;;;;;;;;;;;;;;;;;;;;;;;;;;;;&;&;&W;;;;;;;;;;;;;;;;;;;;&;;;;;;;;;;;;;;&
&;&;;;&;&;;;;;;;;;;;;;;;;;;;;;;;;;;&;&;;;W;;;;;;;;;;;&;&;;;;;;;;;;;;;;;;;;;;;;;;;;;;;;&;&;&W;;;;;;;;;;;;;;;&&;&;&;;;;;;;;;;;;;;&
&;&;;;&;&;;;;;;;;;;;;;;;;;;;;;;;;;;&;&;;;W;;;;;;;;;;;&;&;;;;;;;;;;;;;;;;;;;;;;;;;;;;;;&;&;&W;;;;;;;;;;;;;;;W&;&;&;;;;;;;;;;;;;;&
&;&;;;&;&;;;;;;;;;;;;;;;;;;;;;;;;;;&;&&;W;;;;;;;;;;;;&;&;;;;;;;;;;;;;;;;;;;;;;;;;;;;;;&;&;&W;;;;;;;;;;;;;;;W&;&;&;;;;;;;;;;;;;;&
&;&;;;&;&;;;;;;;;;;;;;;;;;;;;;;;;;;&;;;;W;;;;;;;;;;;;&;&;;;;;;;;;;;;;;;;;;;;;;;;;;;;;;&;&;&W;;;;;;;;;;;;;;;W&;&;&;;;;;;;;;;;;;;&
&;&;;;&;&;;;;;;;;;;;;;;;;;;;;;;;;;;&&&&&&;;;;;;;;;;;;&;&;;;;;;;;;;;;;;;;;;;;;;;;;;;;;;&;&;&W;;;;;;;;;;;;;;;W&;&;&;;;;;;;;;;;;;;&
&;&;;;&;&;;;;;;;;;;;;;;;;;;;;;;;;;;;;;;;;;;;;;;;;;;;;&;&;;;;;;;;;;;;;;;;;;;;;;;;;;;;;;&;&;&WWWWWWWWWWWWWWWWW&;&;&;;;;;;;;;;;;;;&
&;&;;;&;&;;;;;;;;;;;;;;;;;;;;;;;;;;;;;;;;;;;;;;;;;;;;&;&;;;;;;;;;;;;;;;;;;;;;;;;;;;;;;&;&;&&&&&&&&&&&&&&&&&&&;&;&;;;;;;;;;;;;;;&
&;&;;;&;&;;;;;;;;;;;;;;;;;;;;;;;;;;;;;;;;;;;;;;;;;;;;&;&;;;;;;;;;;;;;;;;;;;;;;;;;;;;;;&;;;;;;;;;;;;;;;;;;;;;;;;&;;;;;;;;;;;;;;;&
&;&;;;&;&;;;;;;;;;;;;;;;;;;;;;;;;;;;;;;;;;;;;;;;;;;;;&;&;;;;;;;;;;;;;;;;;;;;;;;;;;;;;;&&&&&&&&&&&&&;&&&&&&&&&&&&;;;;;;;;;;;;;;;&
&;&;;;&;&;;;;;;;;;;;;;;;;;;;;;;;;;;;;;;;;;;;;;;;;;;;;&;&;;;;;;;;;;;;;;;;;;;;;;;;;;;;;;;;;;;;;;;;;;&;&;;;;;;;;;;;;;;;;;;;;;;;;;;&
&;&;;;&;&;;;;;;;;;;;;;;;;;;;;;;;;;;;;;;;;;;;;;;;;;;;;&;&;;;;;;;;;;;;;;;;;;;;;;;;;;;;;;;;;;;;;;;;;;&;&;;;;;;;;;;;;;;;;;;;;;;;;;;&
&;&;;;&;&;;;;;;;;;;;;;;;;;;;;;;;;;;;;;;;;;;;;;;;;;;;;&;&;;;;;;;;;;;;;;;;;;;;;;;;;;;;;;;;;;;;;;;;;;&;&;;;;;;;;;;;;;;;;;;;;;;;;;;&
&;&;;;&;&;;;;;;;;;;;;;;;;;;;;;;;;;;;;;;;;;;;;;;;;;;;;&;&;;;;;;;;;;;;;;;;;;;;;;;;;;;;;;;;;;;;;;;;;;&;&;;;;;;;;;;;;;;;;;;;;;;;;;;&
&;&;;;&;&;;;;;;;;;;;;;;;;;;;;;;;;;;;;;;;;;;;;;;;;;;;;&;&;;;;;;;;;;;;;;;;;;;;;;;;;;;;;;;;;;;;;;;;;;&;&;;;;;;;;;;;;;;;;;;;;;;;;;;&
&;&;;;&;&;;;;;;;;;;;;;;;;;;;;;;;;;;;;;;;;;;;;;;;;;;;;&;&;;;;;;;;;;;;;;;;;;;;;;;;;;;;;;;;;;;;;;;;;;&;&;;;;;;;;;;;;;;;;;;;;;;;;;;&
&WWWWWW;&;;;;;;;;;;;;;;;;;;;;;;;;;;;;;;;;;;;;;;;;;;;;&;&;;;;;;;;;;;;;;;;;;;;;;;;;;;;;;;;;;;;;;;;;;&;&;;;;;;;;;;;;;;;;;;;;;;;;;;&
&;;;;;;;&;;;;;;;;;;;;;;;;;;;;;;;;;;;;;;;;;;;;;;;;;;;;&;&;;;;;;;;;;;;;;;;;;;;;;;;;;;;;;;;;;;;;;;;;;&;&;;;;;;;;;;;;;;;;;;;;;;;;;;&
&;WWWWW;&;;;;;;;;;;;;;;;;;;;;;;;;;;;;;;;;;;;;;;;;;;;;&;&;;;;;;;;;;;;;;;;;;;;;;;;;;;;;;;;;;;;;;;;;;&;&;;;;;;;;;;;;;;;;;;;;;;;;;;&
&;&;;;&;&;;;;;;;;;;;;;;;;;;;;;;;;;;;;;;;;;;;;;;;;;;;;&;&;;;;;;;;;;;;;;;;;;;;;;;;;;;;;;;;;;;;;;;;;;&;&;;;;;;;;;;;;;;;;;;;;;;;;;;&
&;&;;;&;&;;;;;;;;;;;;;;;;;;;;;;;;;;;;;;;;;;;;;;;;;;;;&;&;;;;;;;;;;;;;;;;;;;;;;;;;;;;;;;;;;;;;;;;;;&;&;;;;;;;;;;;;;;;;;;;;;;;;;;&
&;&;;;&;&;;;;;;;;;;;;;;;;;;;;;;;;;;;;;;;;;;;;;;;;;;;;&;&;;;;;;;;;;;;;;;;;;;;;;;;;;;;;;;;;;;;;;;;;;&;&;;;;;;;;;;;;;;;;;;;;;;;;;;&
&;&;;;&;&;;;;;;;;;;;;;;;;;;;;;;;;;;;;;;;;;;;;;;;;;;;;&;&;;;;;;;;;;;;;;;;;;;;;;;;;;;;;;;;;;;;;;;;;;&;&;;;;;;;;;;;;;;;;;;;;;;;;;;&
&;&;;;&;&;;;;;;;;;;;;;;;;;;;;;;;;;;;;;;;;;;;;;;;;;;;;&;&;;;;;;;;;;;;;;;;;;;;;;;;;;;;;;;;;;;;;;;;;;&;&;;;;;;;;;;;;;;;;;;;;;;;;;;&
&;&;;;&;&;;;;;;;;;;;;;;;;;;;;;;;;;;;;;;;;;;;;;;;;;;;;&;&;;;;;;;;;;;;;;;;;;;;;;;;;;;;;;;;;;;;;;;;;;&;&;;;;;;;;;;;;;;;;;;;;;;;;;;&
&;&;;;&;&;;;;;;;;;;;;;;;;;;;;;;;;;;;;;;;;;;;;;;;;;;;;&;&;;;;;;;;;;;;;;;;;;;;;;;;;;;;;;;;;;;;;;;;;;&;&;;;;;;;;;;;;;;;;;;;;;;;;;;&
&;&;;;&;&;;;;;;;;;;;;;;;;;;;;;;;;;;;;;;;;;;;;;;;;;;;;&;&;;;;;;;;;;;;;;;;;;;;;;;;;;;;;;;;;;;;;;;;;;&;&;;;;;;;;;;;;;;;;;;;;;;;;;;&
&;&;;;&;&;;;;;;;;;;;;;;;;;;;;;;;;;;;;;;;;;;;;;;;;;;;;&;&;;;;;;;;;;;;;;;;;;;;;;;;;;;;;;;;;;;;;;;;;;&;&;;;;;;;;;;;;;;;;;;;;;;;;;;&
&;&;;;&;&;;;;;;;;;;;;;;;;;;;;;;;;;;;;;;;;;;;;;;;;;;;;&;&;;;;;;;;;;;;;;;;;;;;;;;;;;;;;;;;;;;;;;;;;;&;&;;;;;;;;;;;;;;;;;;;;;;;;;;&
&;&;;;&;&;;;;;;;;;;;;;;;;;;;;;;;;;;;;;;;;;;;;;;;;;;;;&;&;;;;;;;;;;;;;;;;;;;;;;;;;;;;;;;;;;;;;;;;;;&;&;;;;;;;;;;;;;;;;;;;;;;;;;;&
&;&;;;&;&;;;;;;;;;;;;;;;;;;;;;;;;;;;;;;;;;;;;;;;;;;;;&;&;;;;;;;;;;;;;;;;;;;;;;;;;;;;;;;;;;;;;;;;;;&;&;;;;;;;;;;;;;;;;;;;;;;;;;;&
&;&;;;&;&;;;;;;;;;;;;;;;;;;;&&&&&&&&&&&&&&&&&&&&&;;;;&;&;;;;;;;;;;;;;;;;;;;;;;;;;;;;;;;;;;;;;;;;;;&;&;;;;;;;;;;;;;;;;;;;;;;;;;;&
&;&;;;&;&;;;;;;;;;;;;;;;;;;;&;;;;;;;;;;;;;;;;;;;&;;;;&;&;;;;;;;;;;;;;;;;;;;;;;;;;;;;;;;;;;;;;;;;;;&;&;;;;;;;;;;;;;;;;;;;;;;;;;;&
&;&;;;&;&;;;;;;;;;;;;;;;;;;;&;&&&&&&&&&&&&&&&&&;&;;;;&;&;;;;;;;;;;;;;;;;;;;;;;;;;;;;;;;;;;;;;;;;;;&;&;;;;;;;;;;;;;;;;;;;;;;;;;;&
&;&;;;&;&;;;;;;;;;;;;;;;;;;;&;&;;;;;;;;;;;;;;;&;&;;;;&;&;;;;;;;;;;;;;;;;;;;;;;;;;;;;;;;;;;;;;;;;;;&;&;;;;;;;;;;;;;;;;;;;;;;;;;;&
&;&;;;&;&;;;;;;;;;;;;;;;;;;;&;&;&&&&&&&&&&&&&;&;&;;;;&;&;;;;;;;;;;;;;;;;;;;;;;;;;;;;;;;;;;;;;;;;;;&;&;;;;;;;;;;;;;;;;;;;;;;;;;;&
&;&;;;&;&;;;;;;;;;;;;;;;;;;;&;&;&;;;;;;;;;;)&;&;&;;;;&;&;;;;;;;;;;;;;;;;;;;;;;;;;;;;;;;;;;;;;;;;;;&;&;;;;;;;;;;;;;;;;;;;;;;;;;;&
&;&;;;&;&;;;;;;;;;;;;;;;;;;;&;&;&;&(WWWWWWWW&;&;&;;;;&;&;;;;;;;;;;;;;;;;;;;;;;;;;;;;;;;;;;;;;;;;;;&;&;;;;;;;;;;;;;;;;;;;;;;;;;;&
&;&;;;&;&;;;;;;;;;;;;;;;;;;;&;&;&;&&&&&&&&&&&;&;&;;;;&;&;;;;;;;;;;;;;;;;;;;;;;;;;;;;;;;;;;;;;;;;;;&;&;;;;;;;;;;;;;;;;;;;;;;;;;;&
&;&;;;&;&;;;;;;;;;;;;;;;;;;;&;&;&;;;;;;;;;;;;;&;&;;;;&;&;;;;;;;;;;;;;;;;;;;;;;;;;;;;;;;;;;;;;;;;;;&;&;;;;;;;;;;;;;;;;;;;;;;;;;;&
&;&;;;&;&;;;;;;;;;;;;;;;;;;;&;&;&&&&&&&&&&&&&&&;&;;;;&;&;;;;;;;;;;;;;;;;;;;;;;;;;;;;;;;;;;;;;;;;;;&;&;;;;;;;;;;;;;;;;;;;;;;;;;;&
&;&;;;&;&;;;;;;;;;;;;;;;;;;;&;&;;;;;;;;;;;;;;;;;&;;;;&;&;;;;;;;;;;;;;;;;;;;;;;;;;;;;;;;;;;;;;;;;;;&;&;;;;;;;;;;;;;;;;;;;;;;;;;;&
&;&;;;&;&;;;;;;;;;;;;;;;;;;;&;&&&&&&&&&&&&&&&&&&&;;;;&;&;;;;;;;;;;;;;;;;;;;;;;;;;;;;;;;;;;;;;;;;;;&;&;;;;;;;;;;;;;;;;;;;;;;;;;;&
&;&;;;&;&&&&&&&&&&&&&&&&&&&&&;(;;;;;;;;;;;;;;;;;&&&&&&;&;;;;;;;;;;;;;;;;;;;;;;;;;;;;;;;;;;;;;;;;;;&;&;;;;;;;;;;;;;;;;;;;;;;;;;;&
&;&;;;&;;;;;;;;;;;;;;;;;;;;;;;;;WWWWWWWWWWWWWWW;;;;;;;;&;;;;;;;;;;;;;;;;;;;;;;;;;;;;;;;;;;;;;;;;;;&;&;;;;;;;;;;;;;;;;;;;;;;;;;;&
&;&;;;&;&&&&&&&&&&&&&&&&&&&&&&&&&;;;;;;;;;;;;;&&&&&&&&;&;;;;;;;;;;;;;;;;;;;;;;;;;;;;;;;;;;;;;;;;;;&;&;;;;;;;;;;;;;;;;;;;;;;;;;;&
&;&;;;&;&;;;;;;;;;;;;;;;;;;;;;;;;;;;;;;;;;;;;;;;;;;;;&;&;;;;;;;;;;;;;;;;;;;;;;;;;;;;;;;;;;;;;;;;;;&;&;;;;;;;;;;;;;;;;;;;;;;;;;;&
&;&;;;&;&;;;;;;;;;;;;;;;;;;;;;;;;;;;;;;;;;;;;;;;;;;;;&;&;;;;;;;;;;;;;;;;;;;;;;;;;;;;;;;;;;;;;;;;;;&;&;;;;;;;;;;;;;;;;;;;;;;;;;;&
&;&;;;&;&;;;;;;;;;;;;;;;;;;;;;;;;;;;;;;;;;;;;;;;;;;;;&;&;;;;;;;;;;;;;;;;;;;;;;;;;;;;;;;;;;;;;;;;;;&;&;;;;;;;;;;;;;;;;;;;;;;;;;;&
&;&;;;&;&;;;;;;;;;;;;;;;;;;;;;;;;;;;;;;;;;;;;;;;;;;;;&;&;;;;;;;;;;;;;;;;;;;;;;;;;;;;;;;;;;;;;;;;;;&;&;;;;;;;;;;;;;;;;;;;;;;;;;;&
&;&;;;&;&;;;;;;;;;;;;;;;;;;;;;;;;;;;;;;;;;;;;;;;;;;;;&;&;;;;;;;;;;;;;;;;;;;;;;;;;;;;;;;;;;;;;;;;;;&;&;;;;;;;;;;;;;;;;;;;;;;;;;;&
&;&;;;&;&;;;;;;;;;;;;;;;;;;;;;;;;;;;;;;;;;;;;;;;;;;;;&;&;;;;;;;;;;;;;;;;;;;;;;;;;;;;;;;;;;;;;;;;;;&;&;;;;;;;;;;;;;;;;;;;;;;;;;;&
&;&;;;&;&;;;;;;;;;;;;;;;;;;;;;;;;;;;;;;;;;;;;;;;;;;;;&;&;;;;;;;;;;;;;;;;;;;;;;;;;;;;;;;;;;;;;;;;;;&;&;;;;;;;;;;;;;;;;;;;;;;;;;;&
&;&;;;&;&;;;;;;;;;;;;;;;;;;;;;;;;;;;;;;;;;;;;;;;;;;;;&;&;;;;;;;;;;;;;;;;;;;;;;;;;;;;;;;;;;;;;;;;;;&;&;;;;;;;;;;;;;;;;;;;;;;;;;;&
&;&;;;&;&;;;;;;;;;;;;;;;;;;;;;;;;;;;;;;;;;;;;;;;;;;;;&;&;;;;;;;;;;;;;;;;;;;;;;;;;;;;;;;;;;;;;;;;;;&;&;;;;;;;;;;;;;;;;;;;;;;;;;;&
&;&;;;&;&;;;;;;;;;;;;;;;;;;;;;;;;;;;;;;;;;;;;;;;;;;;;&;&;;;;;;;;;;;;;;;;;;;;;;;;;;;;;;;;;;;;;;;;;;&;&;;;;;;;;;;;;;;;;;;;;;;;;;;&
&;&;;;&;&;;;;;;;;;;;;;;;;;;;;;;;;;;;;;;;;;;;;;;;;;;;;&;&;;;;;;;;;;;;;;;;;;;;;;;;;;;;;;;;;;;;;;;;;;&;&;;;;;;;;;;;;;;;;;;;;;;;;;;&
&;&;;;&;&;;;;;;;;;;;;;;;;;;;;;;;;;;;;;;;;;;;;;;;;;;;;&;&;;;;;;;;;;;;;;;;;;;;;;;;;;;;;;;;;;;;;;;;;;&;&;;;;;;;;;;;;;;;;;;;;;;;;;;&
&;&;;;&;&;;;;;;;;;;;;;;;;;;;;;;;;;;;;;;;;;;;;;;;;;;;;&;&;;;;;;;;;;;;;;;;;;;;;;;;;;;;;;;;;;;;;;;;;;&;&;;;;;;;;;;;;;;;;;;;;;;;;;;&
&;&;;;&;&;;;;;;;;;;;;;;;;;;;;;;;;;;;;;;;;;;;;;;;;;;;;&;&;;;;;;;;;;;;;;;;;;;;;;;;;;;;;;;;;;;;;;;;;;&;&;;;;;;;;;;;;;;;;;;;;;;;;;;&
&;&;;;&;&;;;;;;;;;;;;;;;;;;;;;;;;;;;;;;;;;;;;;;;;;;;;&;&;;;;;;;;;;;;;;;;;;;;;;;;;;;;;;;;;;;;;;;;;;&;&;;;;;;;;;;;;;;;;;;;;;;;;;;&
&;&;;;&;&;;;;;;;;;;;;;;;;;;;;;;;;;;;;;;;;;;;;;;;;;;;;&;&;;;;;;;;;;;;;;;;;;;;;;;;;;;;;;;;;;;;;;;;;;&;&;;;;;;;;;;;;;;;;;;;;;;;;;;&
&;&;;;&;&;;;;;;;;;;;;;;;;;;;;;;;;;;;;;;;;;;;;;;;;;;;;&;&;;;;;;;;;;;;;;;;;;;;;;;;;;;;;;;;;;;;;;;;;;&;&;;;;;;;;;;;;;;;;;;;;;;;;;;&
&;&;;;&;&;;;;;;;;;;;;;;;;;;;;;;;;;;;;;;;;;;;;;;;;;;;;&;&;;;;;;;;;;;;;;;;;;;;;;;;;;;;;;;;;;;;;;;;;;&;&;;;;;;;;;;;;;;;;;;;;;;;;;;&
&;&;;;&;&;;;;;;;;;;;;;;;;;;;;;;;;;;;;;;;;;;;;;;;;;;;;&;&;;;;;;;;;;;;;;;;;;;;;;;;;;;;;;;;;;;;;;;;;;&;&;;;;;;;;;;;;;;;;;;;;;;;;;;&
&;&;;;&;&;;;;;;;;;;;;;;;;;;;;;;;;;;;;;;;;;;;;;;;;;;;;&;&;;;;;;;;;;;;;;;;;;;;;;;;;;;;;;;;;;;;;;;;;;&;&;;;;;;;;;;;;;;;;;;;;;;;;;;&
&;&;;;&;&;;;;;;;;;;;;;;;;;;;;;;;;;;;;;;;;;;;;;;;;;;;;&;&;;;;;;;;;;;;;;;;;;;;;;;;;;;;;;;;;;;;;;;;;;&;&;;;;;;;;;;;;;;;;;;;;;;;;;;&
&;&;;;&;&;;;;;;;;;;;;;;;;;;;;;;;;;;;;;;;;;;;;;;;;;;;;&;&;;;;;;;;;;;;;;;;;;;;;;;;;;;;;;;;;;;;;;;;;;&;&;;;;;;;;;;;;;;;;;;;;;;;;;;&
&;&;;;&;&;;;;;;;;;;;;;;;;;;;;;;;;;;;;;;;;;;;;;;;;;;;;&;&;;;;;;;;;;;;;;;;;;;;;;;;;;;;;;;;;;;;;;;;;;&;&;;;;;;;;;;;;;;;;;;;;;;;;;;&
&;&;;;&;&;;;;;;;;;;;;;;;;;;;;;;;;;;;;;;;;;;;;;;;;;;;;&;&;;;;;;;;;;;;;;;;;;;;;;;;;;;;;;;;;;;;;;;;;;&;&;;;;;;;;;;;;;;;;;;;;;;;;;;&
&;&;;;&;&;;;;;;;;;;;;;;;;;;;;;;;;;;;;;;;;;;;;;;;;;;;;&;&;;;;;;;;;;;;;;;;;;;;;;;;;;;;;;;;;;;;;;;;;;&;&;;;;;;;;;;;;;;;;;;;;;;;;;;&
&;&;;;&;&;;;;;;;;;;;;;;;;;;;;;;;;;;;;;;;;;;;;;;;;;;;;&;&;;;;;;;;;;;;;;;;;;;;;;;;;;;;;;;;;;;;;;;;;;&;&;;;;;;;;;;;;;;;;;;;;;;;;;;&
&;&;;;&;&;;;;;;;;;;;;;;;;;;;;;;;;;;;;;;;;;;;;;;;;;;;;&;&;;;;;;;;;;;;;;;;;;;;;;;;;;;;;;;;;;;;;;;;;;&;&;;;;;;;;;;;;;;;;;;;;;;;;;;&
&;&;;;&;&;;;;;;;;;;;;;;;;;;;;;;;;;;;;;;;;;;;;;;;;;;;;&;&;;;;;;;;;;;;;;;;;;;;;;;;;;;;;;;;;;;;;;;;;;&;&;;;;;;;;;;;;;;;;;;;;;;;;;;&
&;&;;;&;&;;;;;;;;;;;;;;;;;;;;;;;;;;;;;;;;;;;;;;;;;;;;&;&;;;;;;;;;;;;;;;;;;;;;;;;;;;;;;;;;;;;;;;;;;&;&;;;;;;;;;;;;;;;;;;;;;;;;;;&
&;&;;;&;&;;;;;;;;;;;;;;;;;;;;;;;;;;;;;;;;;;;;;;;;;;;;&;&;;;;;;;;;;;;;;;;;;;;;;;;;;;;;;;;;;;;;;;;;;&;&;;;;;;;;;;;;;;;;;;;;;;;;;;&
&;&;;;&;&;;;;;;;;;;;;;;;;;;;;;;;;;;;;;;;;;;;;;;;;;;;;&;&;;;;;;;;;;;;;;;;;;;;;;;;;;;;;;;;;;;;;;;;;;&;&;;;;;;;;;;;;;;;;;;;;;;;;;;&
&;&;;;&;&;;;;;;;;;;;;;;;;;;;;;;;;;;;;;;;;;;;;;;;;;;;;&;&;;;;;;;;;;;;;;;;;;;;;;;;;;;;;;;;;;;;;;;;;;&;&;;;;;;;;;;;;;;;;;;;;;;;;;;&
&;&;;;&;&;;;;;;;;;;;;;;;;;;;;;;;;;;;;;;;;;;;;;;;;;;;;&;&;;;;;;;;;;;;;;;;;;;;;;;;;;;;;;;;;;;;;;;;;;&;&&&&&&&&&&&&&&&&&&&&&&&&&&&&
&;&;;;&;&;;;;;;;;;;;;;;;;;;;;;;;;;;;;;;;;;;;;;;;;;;;;&;&;;;;;;;;;;;;;;;;;;;;;;;;;;;;;;;;;;;;;;;;;;&;;;;;;;;;;;;;;;;;;;;;;;;;;;;&
&W&&&&&W&&&&&&&&&&&&&&&&&&&&&&&&&&&&&&&&&&&&&&&&&&&&&&&&&&&&&&&&&&&&&&&&&&&&&&&&&&&&&&&&&&&&&&&&&&&&&&&&&&&&&&&&&&&&&&&&&&&&&&&&