##^#############################################################################################################################
#..............................................................###.............................................................#
#....................................................##...########...................................................##...######
#..###########.....##################............................#..##########.....##################..........................#
#........#...#..........#...........##########..####.............#.......#...#..........#...........##########..####...........#
#........#..............#...........#..............#..#...#......#.......#..............#...........#..............#..#...#....#
#..####..#...#...########..######...#............###..#...#......#..###..#...#...########..####..................###..#...#....#
#.....#..#...#..#.......#.......#...#........#....#...#...#......#....#..#...#..#.......#....................#....#...#...#....#
#.....#..#......#.......#.......#...##########.....####...##.....#....#..#......#.......#.................####.....####...##...#
#..#..#..#......#..######.......#...............#.........#......#....#..#......#..######.......................#.........#....#
####..#####..####..#....#....#..#...#......######................###..#####........#....#....#.............######..............#
#.........#.....#..#.........#..#...#####..........#..#.....#....#........#........#.........#.....................#..#.....#..#
#.........#.....#..###..######..#...#..#...........#..#...###....#........#........###..######.....................#..#...###..#
#..####.........#..#............#####..#..#...######...#.........#..###............#......................#...######...#.......#
#.....#.....#...#..#............#...#..#..#.........###..........#....#.....#......#......................#.........###........#
#.....#.....#####...##########......#.....#.........#......##....#....#.....#.......##########............#.........#......##..#
####..####..#.............#.......###...###.........#...#...########..####..#.............#...............#.........#.......####
#.......#...#.............#.........#...#...........#...#...#...........#...#.............#.........................#.......#..*
#.......#...######...##########..#..#...#########...#...#...#...........#...######...##########..#..#...#########...#.......#..#
#..###..#..#.....#...#........#..#..#...#...........#...#...#......###..#..#.....#...#........#..#..#...#...........#.......#..#
#...#......#.....#...............#..#...#...........#...#...........#......#.....#...............#..#...#...........#..........#
#...#......#..#..#......#........#..#...#...#####...................#......#..#..#......#........#..#...#...#####..............#
#####...#######..########..#######..#...#...............#..##########...#######............#######..#...#...............#..#####
#.......#...................#....#..#...#...............#......#........#...................#....#..#...#...............#......#
#.......#...................#....#..#...#...#####..######......#........#...................#....#..#...#..........######......#
#.......#.......#########...#.......#...#...#...#.......#......#........#.......#...........#.......#...#...............#......#
#...####........#..............######...#...#...#.......#..#####....####........#..............######...#...............#..#####
#...#.....#.....#.............#.........#...#...#.......#..#...#....#.....#.....#.............#.........#...............#..#...#
#...#.....#.....###########..##.........#...#...#########..#...#....#.....#.....#............##.........#........########..#...#
#.........#.....#.........#...#...###...#...#...#.......#..#...#..........#.....#.............#...###...#...............#..#...#
#.......###.....#.........#...#...#.....#...#...#.......#..#...#........###.....#.............#...#.....#...............#..#...#
#...#####.......########..#...#...#.....#...#...#..#########...#....#####.......#.............#...#.....#..........#########...#
#...#...#...#...#.........#...#...#.....#...#...#..........#...#....#...#...#...#.............#...#.....#..................#...#
#...#...#...#...#.............#...#.....#...#..............#...#....#...#...#...#.............#...#.....#..................#...#
#####...#...#############.........#.....#...#....######...##...#.####...#...#############.........#.....#........######...##...#
#.......................#.........#.....#...#.........#.................................#.........#.....#.............#........#
#.......................#.........##....................................................#.........##............#..............#
#.....###########...#...#######.........#...#...###...................###########...#...#######.........#...#...###............#
#...................#...#...........#...#...#.......................................#...#...........#...#...#..................#
#...................#...#...........#...#...#.......................................#...#...........#...#...#..................#
#################...#...############........####################...##############...#...############........####################
#...................#.................#.............................................#.................#........................#
#.....................................#...............................................................#........................#
#...########.................######...###############...#######.....########.................######...###############...########
#............................#..................#............................................#..................#..............#
#............................#..................#............................................#..................#..............#
#...######..############....####...#............################....######..############....####...#............################
#####....#..#...#..............#...#...######...###.....#...####....#....#..#...#..............#...#...######...###.....#...####
#...#....#..#...#...................#.............#.....#......#....#....#..#...#...................#.............#.....#......#
#........#..#.....#############.....#.............####..#......#.........#..#.....#############.....#.............####..#......#
#........#..#.....#.................#########....#.............#.........#..#.....#.................#..........................#
#####...##..##....#...............################.............#........##..##....#...............##############...............#
#.......#.........#..########.#.....#................######..###....#...#.........#..########.#.....#................######..###
#.......#.........#...........#.....#................#.........#....#...#.........#...........#.....#................#.........#
#..###..#.........#...........#.....#.....###.....#..#.........#....#...#.........#...........#.....#.....###.....#..#.........#
#...#...####......####..#######.....#..#..#.......#..#....######........####......####..#######.....#..#..#.......#..#....######
#...#.......#.....#.....#...........#.....#..######.......#....#............#.....#.....#...........#.....#..######.......#....#
####........####..#.....#..#.....####.....###.....#...#...#....#.#..........####..#.....#..#.....####.....###.....#...#...#....#
#.......#...#.....#..###...######...#.............#...#...#..###........#...#.....#..###...######...#.............#...#...#..###
#.......#...#.....#........#....#...#...#.....#####...#...#....#........#...#.....#........#....#...#...#.....#####...#...#....#
#...#...#...####..#..#######....#...#...#..###........#...#....#....#...#...####..#..#######....#...#...#..###........#...#....#
#...#...................##......#...#...#.............#........#....#...................##......#...#...#.............#........#
#...#...................#.......#...#...#.............#........#....#...................#.......#...#...#.............#........#
#.......................#......................................#...............................................................#
#....##############.....#......................................#...............................................................#
#.......................#......................................###.............................................................#
#.......................#............................##...########...................................................##...######
#...##########.....##################............................#..##########.....##################..........................#
#........#...#..........#...........##########..####.............#.......#...#..........#...........##########..####...........#
#........#..............#...........#..............#..#...#......#.......#..............#...........#..............#..#...#....#
#..####..#...#...########..######...#............###..#...#......#..###..#...#...########..####..................###..#...#....#
#.....#..#...#..#.......#.......#...#........#....#...#...#......#....#..#...#..#.......#....................#....#...#...#....#
#.....#..#......#.......#.......#...##########.....####...##.....#....#..#......#.......#.................####.....####...##...#
#..#..#..#......#..######.......#...............#.........#......#....#..#......#..######.......................#.........#....#
####..#####..####..#....#....#..#...#......######................###..#####........#....#....#.............######..............#
#.........#.....#..#.........#..#...#####..........#..#.....#....#........#........#.........#.....................#..#.....#..#
#.........#.....#..###..######..#...#..#...........#..#...###....#........#........###..######.....................#..#...###..#
*..####.........#..#............#####..#..#...######...#.........#..###............#......................#...######...#.......#
#.....#.....#...#..#............#...#..#..#.........###..........#....#.....#......#......................#.........###........#
#.....#.....#####...##########......#.....#.........#......##....#....#.....#.......##########............#.........#......##..#
####..####..#.............#.......###...###.........#...#...########..####..#.............#...............#.........#.......####
#.......#...#.............#.........#...#...........#...#...#...........#...#.............#.........................#.......#..#
#.......#...######...##########..#..#...#########...#...#...#...........#...######...##########..#..#...#########...#.......#..#
#..###..#..#.....#...#........#..#..#...#...........#...#...#......###..#..#.....#...#........#..#..#...#...........#.......#..#
#...#......#.....#...............#..#...#...........#...#...........#......#.....#...............#..#...#...........#..........#
#...#......#..#..#......#........#..#...#...#####...................#......#..#..#......#........#..#...#...#####..............#
#####...#######..########..#######..#...#...............#..##########...#######............#######..#...#...............#..#####
#.......#...................#....#..#...#...............#......#........#...................#....#..#...#...............#......#
#.......#...................#....#..#...#...#####..######......#........#...................#....#..#...#..........######......#
#.......#.......#########...#.......#...#...#...#.......#......#........#.......#...........#.......#...#...............#......#
#...####........#..............######...#...#...#.......#..#####....####........#..............######...#...............#..#####
#...#.....#.....#.............#.........#...#...#.......#..#...#....#.....#.....#.............#.........#...............#..#...#
#...#.....#.....###########..##.........#...#...#########..#...#....#.....#.....#............##.........#........########..#...#
#.........#.....#.........#...#...###...#...#...#.......#..#...#..........#.....#.............#...###...#...............#..#...#
#.......###.....#.........#...#...#.....#...#...#.......#..#...#........###.....#.............#...#.....#...............#..#...#
#...#####.......########..#...#...#.....#...#...#..#########...#....#####.......#.............#...#.....#..........#########...#
#...#...#...#...#.........#...#...#.....#...#...#..........#...#....#...#...#...#.............#...#.....#..................#...#
#...#...#...#...#.............#...#.....#...#..............#...#....#...#...#...#.............#...#.....#..................#...#
#####...#...#############.........#.....#...#....######...##...#.####...#...#############.........#.....#........######...##...#
*.......................#.........#.....#...#.........#.................................#.........#.....#.............#........#
#.......................#.........##....................................................#.........##............#..............#
#.....###########...#...#######.........#...#...###...................###########...#...#######.........#...#...###............#
#...................#...#...........#...#...#.......................................#...#...........#...#...#..................#
#...................#...#...........#...#...#.......................................#...#...........#...#...#..................#
#################...#...############........####################.################...#...############........####################
#...................#.................#.............................................#.................#........................#
#.....................................#...............................................................#........................#
#...########.................######...###############...#######.....########.................######...###############...########
#............................#..................#............................................#..................#..............#
#............................#..................#............................................#..................#..............#
#...######..############....####...#............################....######..############....####...#............#########...####
#####....#..#...#..............#...#...######...###.....#...####....#....#..#...#..............#...#...######...###.....#...####
#...#....#..#...#...................#.............#.....#......#....#....#..#...#...................#.............#.....#......#
#........#..#.....#############.....#.............####..#......#.........#..#.....#############.....#.............####..#......#
#........#..#.....#.................#########....#.............#.........#..#.....#.................#########....#.............#
#####...##..##....#...............################.............#........##..##....#...............################.............#
#.......#.........#..########.#.....#................######..###....#...#.........#..########.#.....#................######..###
#.......#.........#...........#.....#................#.........#....#...#.........#...........#.....#................#.........#
#..###..#.........#...........#.....#.....###.....#..#.........#....#...#.........#...........#.....#.....###.....#..#.........#
#...#...####......####..#######.....#..#..#.......#..#....######........####......####..#######.....#..#..#.......#..#....######
#...#.......#.....#.....#...........#.....#..######.......#....#............#.....#.....#...........#.....#..######.......#....#
####........####..#.....#..#.....####.....###.....#...#...#....#.#..........####..#.....#..#.....####.....###.....#...#...#....#
#.......#...#.....#..###...######...#.............#...#...#..###........#...#.....#..###...######...#.............#...#...#..###
#.......#...#.....#........#....#...#...#.....#####...#...#....#........#...#.....#........#....#.......#.....#####...#...#....#
#...#...#...####..#..#######....#...#...#..###........#...#....#....#...#...####..#..#######....#.......#..###........#...#....#
#...#...................##......#...#...#.............#........#....#.................................................#........#
#...#...................#.......#...#...#.............#........#....#.................................................#........#
################################################################################################################################
