#)##############################################################
!,!&##..............########.#.#................#.#.#..........#
#.#.###.#.#.#######.#........#.#................#.#.#.########.#
#....##.#.#.#.....#.########.#.##################.#.#.########.#
#....##.#.#.#.....###......#......................#.#.#........#
#....####.#.#..............#.#.##################.#.#.#.########
#.###.....#.################.#.#................#.#.#.#.######.#
#.#.......#.#..................#................#.#.#.#......#.#
#.#.#####.#.######.#############................#.#.#.########.#
#.#.....#.#.#....#.#.........#.#................#.#.#..........#
#.#######.#.#....#.#.........#.#................#.#.#.########.#
#.........#.#....#.#.........#.##################.#.#.#......#.#
#########.#.######.#..............................#.#.#......#.#
#............................#.##################.#.#.#......#.#
#............................#.#................#.#.#.#.....##.#
#..............................#................#.#.#.#.....#..#
#............................###................#.###.#.....####
#..............................................................#
#..............................................................#
#..............................................................#
#..............................................................#
#..............................................................#
#..............................................................#
#..............................................................#
#..............................................................#
#..............................................................#
#..............................................................#
#..............................................................#
#..............................................................#
#..............................................................#
#..............................................................#
#..............................................................#
#..............................................................#
#..............................................................#
#..............................................................#
#..............................................................#
#..............................................................#
#..............................................................#
#..............................................................#
#..............................................................#
#..............................................................#
#..............................................................#
#..............................................................#
#..............................................................#
#..............................................................#
#..............................................................#
#..............................................................#
#..............................................................#
#..............................................................#
#..............................................................#
#..............................................................#
#..............................................................#
#..............................................................#
#..............................................................#
#..............................................................#
#..............................................................#
#..............................................................#
#..............................................................#
#..............................................................#
#..............................................................#
#..............................................................#
#..............................................................#
#..............................................................#
################################################################