&A&&&&W&&&&&&&&&&&&&&&&&&&&&&&&&&&&&&&&&&&&&&&&&&&&&&&&&&&&&&&&&&W&&&&&&&&&&&&&&&&&&&&&&&&&&&&&&&&&&&&&&&&&&&&&&&&&&&&&&&&&&&&&&
&;&..&;&WWWWWWWWWWWW...................................&.&.&.&.&&;&..&;&WWWWWWWWWWWW...........................................&
&;&..&;&W;;;;;;;;;;W...................................&.&.&.&.&&;&..&;&W;;;;;;;;;;W...........................................&
&;&..&;&W;;;;;;;;;;W...................................&.&.&.&.&&;&..&;&W;;;;;;;;;;W...........................................&
&;&..&;&WWWWWW;WWWWW...................................&.&.&.&.&&;&..&;&WWWWWW;WWwWW...........................................&
&;&&&&;&&&&&&&;&&&&&&&&&&&&&&&&&&&&&&&&&&&&&&&&&&&&&&&&&;&;&;&;&&;&&&&;&&&&&&&;&&&&&&&&&&&&&&&&&&&&&&&&&&&&&&&&&&&&&&&&&&&&&&&&&
&;;;;;;;;;;;;;;;;;;;;;;;;;;;;;;;;;;;;;;;;;;;;;;;;;;;;;;;;;;;;;;WW;;;;;;;;;;;;;;;;;;;;;;;;;;;;;;;;;;;;;;;;;;;;;;;;;;;;;;;;;;;;;&"
&;&&&&;&&&&&&&&&&&&&&&&&&&&&&&&&&&&&&&&&&&&&&&&&&&&&&&&&;&;&;&;&&;&&&&;&&&&&&&&&&&&&&&&&&&&&&&&&&&&&&&&&&&&&&&&&&&&&&&&&&&&&&&&&
&;&..&;&...............................................&;&;&;&;&&;&..&;&.......................................................&
&;&..&;&...............................................&;&;&;&;&&;&..&;&.......................................................&
&;&..&;&...............................................&;&;&;&;&&;&..&;&.......................................................&
&;&..&;&...............................................&;&;&;&;&&;&..&;&.......................................................&
&;&..&;&...............................................&;&;&;&;&&;&..&;&.......................................................&
&;&..&;&...............................................&;&;&;&;&&;&..&;&.......................................................&
&;&..&;&...............................................&;&;&;&;&&;&..&;&.......................................................&
&;&..&;&...............................................&;&;&;&;&&;&..&;&.......................................................&
&;&..&;&...............................................&;&;&;&;&&;&..&;&.......................................................&
&;&..&;&...............................................&;&;&;&;&&;&..&;&.......................................................&
&;&..&;&........................................WWWWWWW&;&;&;&;&&;&..&;&.......................................................&
&;&..&;&&&&&&&&&&&&&&&&&&&&&&&&&&&&&&&&&&&&&&&&&W;;;;;;;;WW&.&.&&;&..&;&.......................................................&
&;&..&;&W;;;;;;;;;;;;;;;;;;;;;;;;;;;;;;;;;;;;;;;;;;;;;;;;W.....&&;&..&;&.......................................................&
&;&..&;&&&&&&&&&&&&&&&&&&&&&&&&&&&&&&&&&&&&&&&&&W;;;;;;;;W.....&&;&..&;&.......................................................&
&;&..&;&........................................WWWW;WWWWW.....&&;&..&;&.......................................................&
&;&..&;&.......................................................&&;&..&;&.......................................................&
&;&..&;&.......................................................&&;&..&;&.......................................................&
&;&..&;&.......................................................&&;&..&;&.......................................................&
&;&..&;&.......................................................&&;&..&;&.......................................................&
&;&..&;&.......................................................&&;&..&;&.......................................................&
&;&..&;&.......................................................&&;&..&;&.......................................................&
&;&..&;&.......................................................&&;&..&;&.......................................................&
&;&..&;&.......................................................&&;&..&;&.......................................................&
&;&..&;&.......................................................&&;&..&;&.......................................................&
&;&..&;&.......................................................&&;&..&;&.......................................................&
&;&..&;&.......................................................&&;&..&;&.......................................................&
&;&..&;&.......................................................&&;&..&;&.......................................................&
&;&..&;&.......................................................&&;&..&;&.......................................................&
&;&..&;&.......................................................&&;&..&;&.......................................................&
&;&..&;&.......................................................&&;&..&;&.......................................................&
&;&..&;&.......................................................&&;&..&;&.......................................................&
&;&..&;&.......................................................&&;&..&;&.......................................................&
&;&..&;&.......................................................&&;&..&;&.......................................................&
&;&..&;&.......................................................&&;&..&;&.......................................................&
&;&..&;&.......................................................&&;&..&;&.......................................................&
&;&..&;&.......................................................&&;&..&;&.......................................................&
&;&..&;&.......................................................&&;&..&;&.......................................................&
&;&..&;&.......................................................&&;&..&;&.......................................................&
&;&..&;&.......................................................&&;&..&;&.......................................................&
&;&..&;&.......................................................&&;&..&;&.......................................................&
&;&..&;&.......................................................&&;&..&;&.......................................................&
&;&..&;&.......................................................&&;&..&;&.......................................................&
&;&..&;&.......................................................&&;&..&;&.......................................................&
&;&..&;&.......................................................&&;&..&;&.......................................................&
&;&..&;&.......................................................&&;&..&;&.......................................................&
&;&..&;&.......................................................&&;&..&;&.......................................................&
&;&..&;&.......................................................&&;&..&;&.......................................................&
&;&..&;&.......................................................&&;&..&;&.......................................................&
&;&..&;&.......................................................&&;&..&;&.......................................................&
&;&..&;&.......................................................&&;&..&;&.......................................................&
&;&..&;&.......................................................&&;&..&;&.......................................................&
&;&..&;&.......................................................&&;&..&;&.......................................................&
&;&..&;&.......................................................&&;&..&;&.......................................................&
&;&&&&;&.......................................................&&;&..&;&.......................................................&
&;;;;;;&.......................................................&&;&..&;&.......................................................&
&&&&&&;&&&&&&&&&&&&&&&&&&&&&&&&&&&&&&&&&&&&&&&&&&&&&&&&&&&&&&&&&&;&&&&;&&&&&&&&&&&&&&&&&&&&&&&&&&&&&&&&&&&&&&&&&&&&&&&&&&&&&&&&&
&W&&&&;&&&&&&&&&&&&&&&&&&&&&&&&&&&&&&&&&&&&&&&&&&&&&&&&&&&&&&&&&&;&&&&;&&&&&&&&&&&&&&&&&&&&&&&&&&&&&&&&&&&&&&&&&&&&&&&&&&&&&&&&&
&;&..&;&WWWWWWWWWWWW...........................................&&;&..&;&WWWWWWWWWWWW...........................................&
&;&..&;&W;;;;;;;;;;W...........................................&&;&..&;&W;;;;;;;;;;W...........................................&
&;&..&;&W;;;;;;;;;;W...........................................&&;&..&;&W;;;;;;;;;;W...........................................&
&;&..&;&WWWWWW;WWwWW...........................................&&;&..&;&WWWWWW;WWwWW...........................................&
&;&&&&;&&&&&&&;&&&&&&&&&&&&&&&&&&&&&&&&&&&&&&&&&&&&&&&&&&&&&&&&&&;&&&&;&&&&&&&;&&&&&&&&&&&&&&&&&&&&&&&&&&&&&&&&&&&&&&&&&&&&&&&&&
&;;;;;;;;;;;;;;;;;;;;;;;;;;;;;;;;;;;;;;;;;;;;;;;;;;;;;;;;;;;;;;;;;;;;;;;;;;;;;;;;;;;;;;;;;;;;;;;;;;;;;;;;;;;;;;;;;;;;;;;;;;;;;;&
&;&&&&;&&&&&&&&&&&&&&&&&&&&&&&&&&&&&&&&&&&&&&&&&&&&&&&&&&&&&&&&&&;&&&&;&&&&&&&&&&&&&&&&&&&&&&&&&&&&&&&&&&&&&&&&&&&&&&&&&&&&&&&&&
&;&..&;&.......................................................&&;&..&;&.......................................................&
&;&..&;&.......................................................&&;&..&;&.......................................................&
&;&..&;&.......................................................&&;&..&;&.......................................................&
&;&..&;&.......................................................&&;&..&;&.......................................................&
&;&..&;&.......................................................&&;&..&;&.......................................................&
&;&..&;&.......................................................&&;&..&;&.......................................................&
&;&..&;&.......................................................&&;&..&;&.......................................................&
&;&..&;&.......................................................&&;&..&;&.......................................................&
&;&..&;&.......................................................&&;&..&;&.......................................................&
&;&..&;&.......................................................&&;&..&;&.......................................................&
&;&..&;&.......................................................&&;&..&;&.......................................................&
&;&..&;&.......................................................&&;&..&;&.......................................................&
&;&..&;&.......................................................&&;&..&;&.......................................................&
&;&..&;&.......................................................&&;&..&;&.......................................................&
&;&..&;&.......................................................&&;&..&;&.......................................................&
&;&..&;&.......................................................&&;&..&;&.......................................................&
&;&..&;&.......................................................&&;&..&;&.......................................................&
&;&..&;&.......................................................&&;&..&;&.......................................................&
&;&..&;&.......................................................&&;&..&;&.......................................................&
&;&..&;&.......................................................&&;&..&;&.......................................................&
&;&..&;&.......................................................&&;&..&;&.......................................................&
&;&..&;&.......................................................&&;&..&;&.......................................................&
&;&..&;&.......................................................&&;&..&;&.......................................................&
&;&..&;&.......................................................&&;&..&;&.......................................................&
&;&..&;&.......................................................&&;&..&;&.......................................................&
&;&..&;&.......................................................&&;&..&;&.......................................................&
&;&..&;&.......................................................&&;&..&;&.......................................................&
&;&..&;&.......................................................&&;&..&;&.......................................................&
&;&..&;&.......................................................&&;&..&;&.......................................................&
&;&..&;&.......................................................&&;&..&;&.......................................................&
&;&..&;&.......................................................&&;&..&;&.......................................................&
&;&..&;&.......................................................&&;&..&;&.......................................................&
&;&..&;&.......................................................&&;&..&;&.......................................................&
&;&..&;&.......................................................&&;&..&;&.......................................................&
&;&..&;&.......................................................&&;&..&;&.......................................................&
&;&..&;&.......................................................&&;&..&;&.......................................................&
&;&..&;&.......................................................&&;&..&;&.......................................................&
&;&..&;&.......................................................&&;&..&;&.......................................................&
&;&..&;&.......................................................&&;&..&;&.......................................................&
&;&..&;&.......................................................&&;&..&;&.......................................................&
&;&..&;&.......................................................&&;&..&;&.......................................................&
&;&..&;&.......................................................&&;&..&;&.......................................................&
&;&..&;&.......................................................&&;&..&;&.......................................................&
&;&..&;&.......................................................&&;&..&;&.......................................................&
&;&..&;&.......................................................&&;&..&;&.......................................................&
&;&..&;&.......................................................&&;&..&;&.......................................................&
&;&..&;&.......................................................&&;&..&;&.......................................................&
&;&..&;&.......................................................&&;&..&;&.......................................................&
&;&..&;&.......................................................&&;&..&;&.......................................................&
&;&..&;&.......................................................&&;&..&;&.......................................................&
&;&..&;&.......................................................&&;&..&;&.......................................................&
&;&..&;&.......................................................&&;&..&;&.......................................................&
&;&..&;&.......................................................&&;&..&;&.......................................................&
&;&..&;&.......................................................&&;&..&;&.......................................................&
&;&..&;&.......................................................&&;&..&;&.......................................................&
&&&&&&&&&&&&&&&&&&&&&&&&&&&&&&&&&&&&&&&&&&&&&&&&&&&&&&&&&&&&&&&&&&&&&&&&&&&&&&&&&&&&&&&&&&&&&&&&&&&&&&&&&&&&&&&&&&&&&&&&&&&&&&&&