#@#******#######################################################
#.#*,,,,*.....#.....#.....#.....#.....#.....#.....#.....#.....##
#.@],,,,*.....#.....#.....#.....#.....#.....#.....#.....#.....##
#.#*,,,,*.....#.....#.....#.....#.....#.....#.....#.....#.....##
#.#******.....#.....#.....#.....#.....#.....#.....#.....#.....##
@.########@#####@#####@#####@#####@#####@#####@#####@#####@#####
#..............................................................#
#.########@#####@#####@#####@#####@#####@#####@#####@#####@#####
#.#............................................................#
#.#............................................................#
#.#............................................................#
#.#............................................................#
#.#########@#####@#####@#####@#####@#####@#####@#####@#####@####
#..............................................................#
#.########@#####@#####@#####@#####@#####@#####@#####@#####@#####
#.#............................................................#
#.#............................................................#
#.#............................................................#
#.#............................................................#
#.#########@#####@#####@#####@#####@#####@#####@#####@#####@####
#..............................................................#
#.########@#####@#####@#####@#####@#####@#####@#####@#####@#####
#.#............................................................#
#.#............................................................#
#.#............................................................#
#.#............................................................#
#.#########@#####@#####@#####@#####@#####@#####@#####@#####@####
#.#.&........#...........#.#......#.#......#.#......#.#......#.#
#.#!_!.......#.............@......@.@......@.@......@.@......@.@
#.#.^........#...........#.#......#.#......#.#......#.#......#.#
#.##$##$##$###...........#.#......#.#......#.#......#.#......#.#
#........................#.@......@.@......@.@......@.@......@.@
#........................#.#......#.#......#.#......#.#......#.#
#........................#.#......#.#......#.#......#.#......#.#
#........................#.@......@.@......@.@......@.@......@.@
#........................#.#......#.#......#.#......#.#......#.#
##########################.#......#.#......#.#......#.#......#.#
##########################.########.########.########.########.@
#..............................................................#
#########.########.#######.########.########.########.########.#
#.......@.@......@.@.....@.@......@.@......@.@......@.@......@.#
#.......#.#......#.#.....#.#......#.#......#.#......#.#......#.#
#.......#.#......#.#.....#.#......#.#......#.#......#.#......#.#
#.......@.@......@.@.....@.@......@.@......@.@......@.@......@.#
#.......#.#......#.#.....#.#......#.#......#.#......#.#......#.#
#.......#.#......#.#.....#.#......#.#......#.#......#.#......#.#
#.......@.@......@.@.....@.@......@.@......@.@......@.@......@.#
#.......#.#......#.#.....#.#......#.#......#.#......#.#......#.#
#.......#.#......#.#.....#.#......#.#......#.#......#.#......#.#
#.......@.@......@.@.....@.@......@.@......@.@......@.@......@.#
#.......#.#......#.#.....#.#......#.#......#.#......#.#......#.#
#.......@.@......@.@.....@.@......@.@......@.@......@.@......@.#
#.......#.#......#.#.....#.#......#.#......#.#......#.#......#.#
#.......#.#......#.#.....#.#......#.#......#.#......#.#......#.#
#.......@.@......@.@.....@.@......@.@......@.@......@.@......@.#
#.......#.#......#.#.....#.#......#.#......#.#......#.#......#.#
#.......#.#......#.#.....#.#......#.#......#.#......#.#......#.#
#.......@.@......@.@.....@.@......@.@......@.@......@.@......@.#
#.......#.#......#.#.....#.#......#.#......#.#......#.#......#.#
#.......#.#......#.#.....#.#......#.#......#.#......#.#......#.#
#########.########.#######.########.########.########.########.#
#..............................................................#
#..............................................................#
################################################################